movie_display_name,$_total_box_office,movie_financial_summary_domestic_box_office,movie_financial_summary_international_box_office,$_domestic_DVD_sales,movie_financial_summary_production_budget
Avatar,2783918982,760507625,2023411357,230967498,425000000
Titanic,2207615668,658672302,1548943366,,200000000
Jurassic World,1669164161,652198010,1016966151,15869432,215000000
The Avengers,1519479547,623279547,896200000,109833695,225000000
Furious 7,1516246709,351032910,1165213799,17355448,190000000
The Avengers: Age of Ultron,1404705868,459005868,945700000,16669698,250000000
Harry Potter and the Deathly Hallows: Part II,1341511219,381011219,960500000,100892266,125000000
Frozen,1274234980,400738009,873496971,204943952,150000000
Iron Man 3,1215392272,408992272,806400000,25338875,200000000
Minions,1162153250,335856845,826296405,,74000000
The Lord of the Rings: The Return of the King,1141408667,377845905,763562762,,94000000
Transformers: Dark of the Moon,1123790543,352390543,771400000,56596544,195000000
Skyfall,1110526981,304360277,806166704,47663877,200000000
Transformers: Age of Extinction,1104039076,245439076,858600000,25385886,210000000
The Dark Knight Rises,1084439099,448139099,636300000,71550111,275000000
Toy Story 3,1069818229,415004880,654813349,188353092,200000000
Pirates of the Caribbean: Dead Man's Chest,1066215812,423315812,642900000,320862849,225000000
Pirates of the Caribbean: On Stranger Tides,1045663875,241063875,804600000,30495293,250000000
Jurassic Park,1038812584,395708305,643104279,,63000000
Star Wars Ep. I: The Phantom Menace,1027044677,474544677,552500000,,115000000
Alice in Wonderland,1025491110,334191110,691300000,82392151,200000000
The Hobbit: An Unexpected Journey,1017003568,303003568,714000000,34291070,250000000
The Dark Knight,1002891358,533345358,469546000,282151234,185000000
The Lion King,987480140,422780140,564700000,87279169,79300000
Despicable Me 2,974873764,368065385,606808379,124785357,76000000
Harry Potter and the Sorcerer’s Stone,974755371,317575550,657179821,,125000000
Pirates of the Caribbean: At World's End,963420425,309420425,654000000,312232971,300000000
The Hobbit: The Desolation of Smaug,960366855,258366855,702000000,40345708,250000000
Harry Potter and the Deathly Hallows: Part I,959301070,295001070,664300000,94451714,125000000
The Hobbit: The Battle of the Five Armies,955119788,255119788,700000000,22868661,250000000
Harry Potter and the Order of the Phoenix,942943935,292004738,650939197,250958851,150000000
Finding Nemo,936429370,380529370,555900000,,94000000
Harry Potter and the Half-Blood Prince,935083686,301959197,633124489,144559514,250000000
The Lord of the Rings: The Two Towers,934703179,342548984,592154195,,94000000
Shrek 2,932252921,436471036,495781885,,70000000
Harry Potter and the Goblet of Fire,896911078,290013036,606898042,540450950,150000000
Spider-Man 3,890875303,336530303,554345000,125012910,258000000
The Lord of the Rings: The Fellowship of the Ring,887217688,315544750,571672938,,109000000
Ice Age: Continental Drift,879765137,161321843,718443294,42923108,95000000
Harry Potter and the Chamber of Secrets,878979634,261987880,616991754,,100000000
The Hunger Games: Catching Fire,864868047,424668047,440200000,59932615,130000000
Ice Age: Dawn of the Dinosaurs,859701857,196573705,663128152,104091204,90000000
Inside Out,852343178,356418708,495924470,,175000000
Star Wars Ep. III: Revenge of the Sith,848998877,380270577,468728300,,115000000
Transformers: Revenge of the Fallen,836519699,402111870,434407829,221996361,210000000
Inception,832584416,292576195,540008221,86223190,160000000
"The Twilight Saga: Breaking Dawn, Part 2",829724737,292324737,537400000,76433565,136200000
Spider-Man,821706375,403706375,418000000,,139000000
Independence Day,817355682,306124059,511231623,,75000000
Shrek the Third,805623351,321012359,484610992,176566326,160000000
Harry Potter and the Prisoner of Azkaban,796688549,249538952,547149597,,130000000
ET: The Extra-Terrestrial,792804231,434949459,357854772,,10500000
Fast and Furious 6,789952811,238679850,551272961,55302633,160000000
02012,788408539,166112167,622296372,52100596,200000000
Indiana Jones and the Kingdom of the Crystal Skull,786558145,317023851,469534294,117107120,185000000
Star Wars Ep. IV: A New Hope,786535665,460935665,325600000,22775633,11000000
Spider-Man 2,783705001,373524485,410180516,31252739,200000000
Guardians of the Galaxy,771172112,333172112,438000000,43041922,170000000
The Da Vinci Code,767820459,217536138,550284321,100215702,125000000
Maleficent,758407328,241407328,517000000,35651742,180000000
The Amazing Spider-Man,757890267,262030663,495859604,38544516,220000000
Shrek Forever After,755903876,238395990,517507886,60465972,165000000
Spectre,751232119,177732119,573500000,,300000000
X-Men: Days of Future Past,748121534,233921534,514200000,23327550,200000000
Madagascar 3: Europe's Most Wanted,746921271,216391482,530529789,56120903,145000000
Monsters University,743588329,268488329,475100000,61254992,200000000
The Matrix Reloaded,738576929,281553689,457023240,,150000000
Up,731542621,293004164,438538457,215591288,175000000
"The Chronicles of Narnia: The Lion, the Witch and the Wardrobe",720539572,291710957,428828615,439932794,180000000
Gravity,716392705,274092705,442300000,25139849,110000000
Captain America: The Winter Soldier,713846958,259746958,454100000,24051326,170000000
The Hunger Games: Mockingjay - Part 1,709635885,337135885,372500000,26151050,125000000
The Amazing Spider-Man 2,708996336,202853933,506142403,20692895,200000000
Transformers,708098205,319071806,389026399,294800663,151000000
The Twilight Saga: Eclipse,706102828,300531751,405571077,180849285,68000000
Dawn of the Planet of the Apes,703545589,208545589,495000000,22551622,170000000
Mission: Impossible - Rogue Nation,700868363,195042377,505825986,,150000000
Mission: Impossible - Ghost Protocol,694713230,209397903,485315327,24277153,145000000
"The Twilight Saga: Breaking Dawn, Part 1",689420051,281287133,408132918,110882555,127500000
The Twilight Saga: New Moon,687557727,296623634,390934093,203598801,50000000
Forrest Gump,679857164,330151138,349706026,,55000000
The Hunger Games,677923379,408010692,269912687,150538055,80000000
The Sixth Sense,672806292,293506292,379300000,,40000000
Man of Steel,667999518,291045518,376954000,42063561,225000000
Interstellar,665417894,188017894,477400000,12026849,165000000
Kung Fu Panda 2,664837547,165249063,499588484,37704074,150000000
Men in Black 3,654213485,179020854,475192631,31361320,215000000
Big Hero 6,652127828,222527828,429600000,39131500,165000000
Ice Age: The Meltdown,651899282,195330621,456568661,135257967,75000000
Star Wars Ep. II: Attack of the Clones,648200000,302181125,346018875,,115000000
Pirates of the Caribbean: The Curse of the Black Pearl,634954103,305411224,329542879,,125000000
Thor: The Dark World,633360018,206360018,427000000,32409957,150000000
Kung Fu Panda,631910531,215434591,416475940,145169437,130000000
Fast Five,629969804,209837675,420132129,40260190,125000000
Ratatouille,626549695,206445654,420104041,189382771,150000000
Hancock,624234272,227946274,396287998,99943791,150000000
Iron Man 2,623256345,312128345,311128000,122727783,170000000
The Passion of the Christ,622420667,370782930,251637737,6170219,25000000
The Lost World: Jurassic Park,618626844,229074524,389552320,,75000000
How to Train Your Dragon 2,616102924,177002924,439100000,33176558,145000000
The Incredibles,614726752,261441092,353285660,,92000000
Life of Pi,607987022,124987022,483000000,23102122,120000000
War of the Worlds,606836535,234280354,372556181,,132000000
Mamma Mia!,602133452,143762955,458370497,147042399,52000000
Madagascar: Escape 2 Africa,599516844,180010950,419505894,113293542,150000000
Casino Royale,594275385,167220102,427055283,208984717,102000000
Quantum of Solace,591692078,169368427,422323651,52920906,230000000
Men in Black,587247615,250147615,337100000,,90000000
Tangled,586581936,200821936,385760000,153524694,260000000
The Hangover Part II,586464305,254464305,332000000,45783166,80000000
I am Legend,585532684,256393010,329139674,141226173,150000000
Iron Man,582443126,318604126,263839000,181937651,186000000
Night at the Museum,581570293,250863268,330707025,153560084,110000000
The Croods,573068425,187168425,385900000,46272477,135000000
Star Wars Ep. VI: Return of the Jedi,572625409,309125409,263500000,18507195,32500000
Fifty Shades of Grey,570455257,166167230,404288027,22505680,40000000
The Smurfs,563749323,142614158,421135165,39244988,110000000
Cars 2,560155383,191450875,368704508,99353414,200000000
"Monsters, Inc.",559757719,289423425,270334294,,115000000
The Martian,559753732,218889878,340863854,,108000000
The Day After Tomorrow,556319450,186740799,369578651,,125000000
Madagascar,556130620,193166575,362964045,,75000000
Ted,556016627,218665740,337350887,82409638,50000000
Puss in Boots,554987477,149260504,405726973,48701104,130000000
Brave,554606532,237282182,317324350,124756621,185000000
Armageddon,554595209,201573391,353021818,,140000000
King Kong,550517357,218080025,332437332,191436550,207000000
Mission: Impossible 2,549588516,215409889,334178627,,120000000
American Sniper,547326372,350126372,197200000,28952439,58000000
Despicable Me,543495033,251513985,291981048,192541690,69000000
Sherlock Holmes: A Game of Shadows,535663443,186848418,348815025,53214895,125000000
Cinderella,534551353,201151353,333400000,8828576,95000000
Star Wars Ep. V: The Empire Strikes Back,534058751,290158751,243900000,19946205,23000000
WALL-E,532590994,223808164,308782830,195426790,180000000
World War Z,531514650,202359711,329154939,22002092,190000000
Godzilla,529072193,200672193,328400000,16656363,160000000
The Simpsons Movie,527071022,183135014,343936008,97517713,72500000
Ant-Man,518470613,180070613,338400000,,130000000
Meet the Fockers,516567575,279167575,237400000,,60000000
Terminator 2: Judgment Day,513815401,201858746,311956655,,100000000
Toy Story 2,511329494,245823397,265506097,,90000000
Ghost,506112351,206143657,299968694,,22000000
Sherlock Holmes,498438212,209028679,289409533,59084820,90000000
Twister,495700000,241688385,254011615,,88000000
Aladdin,495277270,208577270,286700000,,28000000
How to Train Your Dragon,494870991,217581231,277289760,140681517,165000000
Rio 2,493738435,131538435,362200000,27424852,130000000
Clash of the Titans,493214888,163214888,330000000,31253169,125000000
Shrek,491812794,267655011,224157783,,50000000
Angels & Demons,490875846,133375846,357500000,36264900,150000000
Oz the Great and Powerful,489570996,234770996,254800000,27577961,200000000
Rio,487519809,143619809,343900000,67328062,90000000
Mr. and Mrs. Smith,486124090,186336279,299787811,,110000000
Teenage Mutant Ninja Turtles,485004754,191204754,293800000,32874460,125000000
Saving Private Ryan,484819491,216119491,268700000,,65000000
Troy,484161265,133298577,350862688,,150000000
Bruce Almighty,483473962,242704995,240768967,,81000000
Rise of the Planet of the Apes,482860185,176760185,306100000,43503249,93000000
Charlie and the Chocolate Factory,475825484,206459076,269366408,,150000000
Wreck-It Ralph,473412677,189412677,284000000,61242847,165000000
Indiana Jones and the Last Crusade,472705225,195705225,277000000,23207690,48000000
Jaws,470700000,260000000,210700000,3082604,12000000
San Andreas,469590832,155190832,314400000,10758175,110000000
Home Alone,468427450,277504018,190923432,,15000000
Star Trek Into Darkness,466978661,228778661,238200000,26126498,190000000
The Hangover,465764086,277322503,188441583,199324779,35000000
The Matrix,463420706,171383253,292037453,,65000000
Cars,461651246,244082982,217568264,307340806,70000000
X-Men: The Last Stand,459359555,234362462,224997093,144801278,210000000
The Lego Movie,457729388,257784718,199944670,50179245,60000000
Gladiator,457683805,187683805,270000000,,103000000
Mission: Impossible,457607112,180891004,276716108,,80000000
National Treasure 2: Book of Secrets,457325804,219961501,237364303,102828608,00000
The Last Samurai,456810575,111110575,345700000,,140000000
00300,454139586,210592590,243546996,276415077,60000000
Beauty and the Beast,451421625,218951625,232470000,101378450,20000000
Ocean's Eleven,450728529,183417150,267311379,,85000000
Lucy,450573960,126573960,324000000,13220963,40000000
Thor,449326618,181030624,268295994,39879661,150000000
Pearl Harbor,449239855,198539855,250700000,,151500000
Tarzan,448191819,171091819,277100000,,145000000
The Hunger Games: Mockingjay - Part 2,446593802,204193802,242400000,,160000000
Alvin and the Chipmunks: The Squeakquel,443483213,219614612,223868601,75546547,70000000
Les Miserables,442169052,148809770,293359282,39399461,65000000
The Bourne Ultimatum,442161562,227471070,214690492,126890024,130000000
Men in Black 2,441767803,190418803,251349000,,140000000
Mrs. Doubtfire,440783653,218692701,222090952,,25000000
Terminator: Genisys,440160956,89760956,350400000,,155000000
Hotel Transylvania 2,437085725,167185725,269900000,,80000000
The Mummy Returns,435040395,202007640,233032755,,98000000
Terminator 3: Rise of the Machines,433058296,150358296,282700000,,170000000
Die Another Day,431932247,160932247,271000000,,142000000
The King’s Speech,430821168,138797449,292023719,40957850,15000000
Pretty Woman,429359276,175119672,254239604,,14000000
The Matrix Revolutions,427289109,139259759,288029350,,150000000
Cast Away,427230516,233632142,193598374,,85000000
Les Intouchables,426480871,13182281,413298590,4857110,00000
Django Unchained,425373688,162805434,262568254,32370800,100000000
The Chronicles of Narnia: The Voyage of the Dawn Treader,418186950,104386950,313800000,35359159,155000000
The Chronicles of Narnia: Prince Caspian,417341288,141621490,275719798,99163110,225000000
The Wolverine,416456852,132556852,283900000,36985540,115000000
The Mummy,416247825,155247825,261000000,,80000000
Dances with Wolves,415285106,175293948,239991158,,19000000
Sex and the City,415247258,152647258,262600000,95927680,57500000
Pacific Rim,411002906,101802906,309200000,21369930,190000000
Batman,409132777,248972777,160160000,,35000000
Signs,408265690,227965690,180300000,,70702619
Rain Man,408080878,168106313,239974565,,25000000
X2,407711549,214949694,192761855,,125000000
The Mummy: Tomb of the Dragon Emperor,405545959,102277510,303268449,45637984,175000000
Kingsman: The Secret Service,404561724,128261724,276300000,14092385,00000
The Exorcist,402735134,204868002,197867132,,12000000
Twilight,402280159,192769854,209510305,238026904,37000000
Night at the Museum: Battle of the Smithsonian,402231063,177243721,224987342,51544069,150000000
Snow White and the Huntsman,401016924,155136755,245880169,31489764,170000000
The Bodyguard,400588566,111634286,288954280,,25000000
Prometheus,399005706,126477084,272528622,18497877,125000000
Tron: Legacy,397562763,172062763,225500000,26990140,200000000
Mission: Impossible III,397501348,133501348,264000000,49918230,150000000
The Wolf of Wall Street,391976723,116900694,275076029,16951813,100000000
Gone with the Wind,390525192,198680470,191844722,,3900000
Robin Hood: Prince of Thieves,390366200,165360108,225006092,,50000000
Raiders of the Lost Ark,389925971,248159971,141766000,23139994,20000000
Grease,387513770,181813770,205700000,22741554,6000000
Ice Age,386116343,176387405,209728938,,65000000
Home,386085953,177397510,208688443,25639041,130000000
Star Trek,385680446,257730019,127950427,114928946,140000000
Back to the Future,385524862,212259762,173265100,5629751,19000000
Happy Feet,385000317,198000317,187000000,206546318,85000000
Monster Hunt,384884229,00000,384884229,,00000
Slumdog Millionaire,384519665,141319928,243199737,37992376,14000000
Live Free or Die Hard,382288147,134529403,247758744,101018239,110000000
Monsters vs. Aliens,381687380,198351526,183335854,91122335,175000000
Taken 2,377807404,139854287,237953117,44883007,45000000
Godzilla,375827709,136142003,239685706,,125000000
My Big Fat Greek Wedding,374890034,241438208,133451826,,5000000
X-Men Origins: Wolverine,374825760,179883157,194942603,85034583,150000000
What Women Want,374105123,182805123,191300000,,65000000
Superman Returns,374085065,200120000,173965065,85604491,232000000
The Adventures of Tintin,373993951,77591831,296402120,17776796,130000000
Mad Max: Fury Road,373136354,153636354,219500000,13511757,150000000
G.I. Joe: Retaliation,371923060,122523060,249400000,16546607,140000000
Shark Tale,371917043,161412000,210505043,,75000000
Captain America: The First Avenger,370569776,176654505,193915271,46564072,140000000
Gone Girl,368567189,167767189,200800000,15395276,61000000
Penguins of Madagascar,367650911,83350911,284300000,9205710,132000000
The Golden Compass,367262558,70107728,297154830,41885405,205000000
Hitch,366784257,177784257,189000000,,55000000
Die Hard: With a Vengeance,366072426,99983259,266089167,,90000000
Jurassic Park III,365900000,181166115,184733885,,93000000
Terminator Salvation,365491792,125322469,240169323,30157379,200000000
True Lies,365291539,146273950,219017589,,100000000
Edge of Tomorrow,364406256,100206256,264200000,9874508,178000000
Toy Story,364402211,191652928,172749283,,30000000
Notting Hill,363728226,116089678,247638548,,42000000
A Bug's Life,363089431,162792677,200296754,,45000000
Fast & Furious,363064265,155064265,208000000,66515081,85000000
Ocean's Twelve,362989076,125531634,237457442,,110000000
Alvin and the Chipmunks,362605033,217326974,145278059,138708106,55000000
Planet of the Apes,362211740,180011740,182200000,,100000000
The Hangover 3,362000072,112200072,249800000,13886231,103000000
The World is Not Enough,361730660,126930660,234800000,,135000000
There's Something About Mary,360099156,176483808,183615348,,22000000
Batman Begins,359142722,205343774,153798948,,150000000
Minority Report,358824714,132024714,226800000,,102000000
Top Gun,356800601,179800601,177000000,,15000000
Night at the Museum: Secret of the Tomb,356546621,113746621,242800000,14653696,127000000
American Beauty,356258047,130058047,226200000,,15000000
Dinosaur,356148063,137748063,218400000,,127500000
Goldeneye,355978900,105978900,250000000,4077930,60000000
Catch Me if You Can,355612291,164606800,191005491,,52000000
Home Alone 2: Lost in New York,355413379,170004045,185409334,,20000000
X-Men: First Class,355408305,146408305,209000000,34063100,160000000
The Flintstones,353357367,125388575,227968792,,45000000
Noah,352831065,101200044,251631021,11760839,130000000
The Karate Kid,351774938,176591618,175183320,56285448,40000000
Now You See Me,351723989,117723989,234000000,15315088,75000000
The Mask,351574149,119874149,231700000,,18000000
The Great Gatsby,351040419,144840419,206200000,28711081,190000000
Doctor Seuss' The Lorax,350976753,214030500,136946253,85824669,67500000
Basic Instinct,350853973,115881197,234972776,,00000
Hannibal,350100000,165091986,185008014,,87000000
Who Framed Roger Rabbit?,349318645,151931137,197387508,,70000000
Deep Impact,349300426,140300426,209000000,,80000000
Alvin and the Chipmunks: Chipwrecked,349088523,133107389,215981134,44083529,80000000
"I, Robot",348623912,144795350,203828562,,105000000
The Smurfs 2,348547523,71017784,277529739,20146812,110000000
Rush Hour 2,347425832,226164286,121261546,,90000000
Pocahontas,347087906,141567679,205520227,,55000000
Hotel Transylvania,345907363,148313048,197594315,55198380,85000000
The Maze Runner,345527862,102427862,243100000,20455763,34000000
How the Grinch Stole Christmas,345141403,260044825,85096578,,123000000
The Fugitive,342333917,172494360,169839557,,44000000
Wanted,342235034,134327125,207907909,74161820,75000000
Enchanted,340384141,127706877,212677264,89281522,85000000
Tomorrow Never Dies,339479326,125279326,214200000,,110000000
Close Encounters of the Third Kind,337700000,166000000,171700000,,20000000
Batman Forever,336495936,183997904,152498032,,100000000
Over the Hedge,336002981,155019340,180983641,130425424,80000000
The Rock,335955936,133955936,202000000,,75000000
Apollo 13,334065864,172036360,162029504,,65000000
22 Jump Street,331333876,191719337,139614539,14474312,50000000
National Treasure,331323410,173005002,158318408,,100000000
Black Swan,331266710,106954678,224312032,23985885,13000000
300: Rise of an Empire,330780051,106580051,224200000,16674466,110000000
Fantastic Four,330716569,154695569,176021000,18550828,87500000
The Curious Case of Benjamin Button,329809326,127509326,202300000,47712328,160000000
The Perfect Storm,328711434,182618434,146093000,,120000000
Indiana Jones and the Temple of Doom,328283524,175083524,153200000,23317323,28000000
Se7en,328058010,100058010,228000000,,30000000
Bolt,328015209,114053759,213961450,93399175,150000000
Taken 3,327656424,89256424,238400000,13138840,48000000
The Devil Wears Prada,326073155,124740460,201332695,95933800,35000000
The Hunchback of Notre Dame,325478752,100117603,225361149,,100000000
Back to the Future Part II,322666269,109116271,213549998,,40000000
Robin Hood,322241588,105269730,216971858,47491423,210000000
Megamind,321887208,148415853,173471355,50420074,130000000
Crocodile Dundee,321534511,168134511,153400000,,8800000
Schindler's List,320792986,95494598,225298388,,25000000
The Last Airbender,319542756,131601062,187941694,30338712,150000000
The Polar Express,319049659,194949659,124100000,,170000000
Journey 2: The Mysterious Island,318146162,103860290,214285872,22086915,79000000
The Conjuring,318000141,137400141,180600000,14114103,20000000
A Beautiful Mind,317668058,170708996,146959062,,78000000
Inglourious Basterds,316915264,120774594,196140670,68867087,70000000
Disney's A Christmas Carol,315709697,137855863,177853834,41533072,190000000
Air Force One,314932668,172620724,142311944,,85000000
Lethal Weapon 3,314768020,139799547,174968473,,35000000
The Proposal,314709717,163958031,150751686,107701780,40000000
Prince of Persia: Sands of Time,314594597,90759676,223834921,36487511,200000000
As Good as it Gets,313271386,147637474,165633912,,50000000
The Expendables 2,311979256,85028192,226951064,24193699,100000000
Fatal Attraction,311908296,148453989,163454307,,14000000
Ocean's Thirteen,311744465,117144465,194600000,48389923,85000000
The SpongeBob Movie: Sponge Out of Water,311594032,162994032,148600000,11512045,74000000
Beverly Hills Cop,311449244,229909722,81539522,,15000000
Little Fockers,310650574,148438600,162211974,20614562,100000000
Austin Powers: The Spy Who Shagged Me,310250345,205957794,104292551,,35000000
Maze Runner: The Scorch Trials,310203302,81203302,229000000,,61000000
Chicken Little,310043823,135386665,174657158,142664304,60000000
Runaway Bride,310030259,152149590,157880669,,70000000
Ransom,308656140,136448821,172207319,,70000000
Chicago,307687518,170687518,137000000,,30000000
The Pursuit of Happyness,307325633,162586036,144739597,93800774,55000000
Rise of the Guardians,306900902,103412758,203488144,40611912,145000000
The Blind Side,305705794,255959475,49746319,123148756,35000000
Wrath of the Titans,305270083,83670083,221600000,20256704,150000000
Battleship,305218228,65233400,239984828,18379218,209000000
Meet the Parents,304599899,166225040,138374859,,55000000
A Good Day to Die Hard,304249198,67349198,236900000,15159864,92000000
101 Dalmatians,304192867,136182161,168010706,,00000
The Fault in Our Stars,303572350,124872350,178700000,24517240,12000000
Mulan,303498149,120618403,182879746,,90000000
Liar Liar,302695380,181395380,121300000,,45000000
G.I. Joe: The Rise of Cobra,302469017,150201498,152267519,75499333,175000000
Rambo: First Blood Part II,300400000,150415432,149984568,,44000000
Superman,300200000,134218018,165981982,,55000000
Van Helsing,300150546,120150546,180000000,,170000000
Horton Hears a Who,299477886,154529439,144948447,83716647,85000000
Shutter Island,299461782,128012934,171448848,27087714,80000000
My Best Friend's Wedding,298915378,126805112,172110266,,46000000
Stuart Little,298815224,140015224,158800000,,105000000
Rocky IV,296447780,123947780,172500000,,00000
X-Men,296339717,157299717,139040000,,75000000
Resident Evil: Afterlife,295874190,60128566,235745624,22093657,57500000
Insurgent,295279072,130179072,165100000,11197650,110000000
Ghostbusters,295212467,242212467,53000000,,30000000
Sex and the City 2,294680778,95347692,199333086,32744573,95000000
Doctor Dolittle,294156464,144156464,150000000,,71500000
G-Force,292817841,119436770,173381071,57036750,150000000
Austin Powers in Goldmember,292738626,213117789,79620837,,63000000
Look Who's Talking,291848720,134837533,157011187,,00000
Hook,291121554,109921554,181200000,,70000000
The Green Mile,290701374,136801374,153900000,,60000000
Salt,290650494,118311368,172339126,34248145,130000000
The Departed,289660619,132384315,157276304,141096054,90000000
Bridesmaids,289527030,169106725,120420305,70433716,32500000
What Lies Beneath,288600000,155370362,133229638,,90000000
The Bourne Supremacy,288587450,176087450,112500000,,85000000
Fantastic Four: Rise of the Silver Surfer,288215319,131921738,156293581,67661302,120000000
Oblivion,287916633,89107235,198809398,14483683,120000000
Bee Movie,287594577,126631277,160963300,91242075,150000000
Turbo,286896578,83028130,203868448,43087257,135000000
Pitch Perfect 2,286654563,183785415,102869148,11165709,29000000
American Pie 2,286500000,145096820,141403180,,30000000
The Sound of Music,286214286,163214286,123000000,,8200000
Elysium,286192091,93050117,193141974,16050868,120000000
Lethal Weapon 4,284690200,129734803,154955397,,140000000
The Wedding Crashers,283218368,209218368,74000000,,40000000
John Carter,282778100,73058679,209719421,23443423,275000000
Saturday Night Fever,282400000,139486124,142913876,,00000
Speed,282312677,120360822,161951855,,30000000
Casper,282209181,100237375,181971806,,55000000
Bridget Jones's Diary,281527158,71500556,210026602,,25000000
Coming to America,281442024,120794325,160647699,,00000
The Bourne Legacy,280355920,113203870,167152050,30077731,125000000
Shakespeare in Love,279423528,100241322,179182206,,26000000
The Tourist,278731369,67631157,211100212,19454013,100000000
Scary Movie,277200000,157019771,120180229,,19000000
Scooby-Doo,276294164,153294164,123000000,,84000000
Divergent,276014965,150947895,125067070,34076053,85000000
Beverly Hills Cop II,275932902,152932902,123000000,,20000000
Sen to Chihiro no Kamikakushi,274949886,10049886,264900000,,19000000
Gran Torino,274543085,148095302,126447783,67240752,25000000
High School Musical 3: Senior Year,274392880,90559416,183833464,60957206,11000000
Cloudy with a Chance of Meatballs 2,274392649,119793567,154599082,21534938,78000000
The Nutty Professor,273769345,128769345,145000000,,55000000
Jerry Maguire,273668230,153620822,120047408,,50000000
Lincoln,273346281,182207973,91138308,22651837,65000000
Lara Croft: Tomb Raider,273330185,131144183,142186002,,94000000
Bad Boys II,272940870,138540870,134400000,,130000000
Grown Ups,272223430,162001186,110222244,49254010,75000000
The Princess and the Frog,270997378,104400899,166596479,95666237,105000000
Neighbors,270594534,150086800,120507734,16871923,18000000
The Firm,270340892,158340892,112000000,,42000000
Mr. Peabody & Sherman,269806430,111506430,158300000,18972993,145000000
The Silence of the Lambs,269507594,124507594,145000000,,20000000
"10,000 B.C.",269065678,94784201,174281477,27300295,105000000
The Godfather,268355541,134821952,133533589,,7000000
Exodus: Gods and Kings,268314513,65014513,203300000,6887306,140000000
The Expendables,268268174,103068524,165199650,49030709,82000000
Bambi,268000000,102797000,165203000,,00000
American Gangster,267985456,130164645,137820811,79574694,100000000
We're the Millers,267816276,150394119,117422157,32041734,37000000
xXx,266985000,141715000,125270000,,70000000
Batman Returns,266824291,162833635,103990656,,80000000
Something's Gotta Give,266685242,124685242,142000000,,80000000
Waterworld,264214660,88214660,176000000,,175000000
The Truman Show,263966701,125466701,138500000,,60000000
Bridget Jones: The Edge Of Reason,263894551,40203020,223691531,,50000000
Real Steel,263880341,85463309,178417032,29755032,110000000
The Fifth Element,263869158,63540020,200329138,,95000000
Cinderella,263591415,85000000,178591415,,2900000
The Incredible Hulk,263144885,134533885,128611000,67810986,137500000
Epic,262794441,107518682,155275759,31794583,100000000
Jumanji,262409938,100109938,162300000,,65000000
Borat,261443242,128505958,132937284,62696374,18000000
Indecent Proposal,261254196,101268255,159985941,,00000
Robots,260700012,128200012,132500000,,80000000
The Lone Ranger,259989910,89289910,170700000,25017221,275000000
Charlie's Angels,259736090,125305545,134430545,,90000000
Paddington,259541430,76223578,183317852,9388308,55000000
Knight and Day,258751370,76423035,182328335,22676939,117000000
Out of Africa,258210860,79096868,179113992,,31000000
Super 8,257972745,127004179,130968566,20649526,50000000
American Hustle,257878294,150117807,107760487,9008031,40000000
The Full Monty,257845980,45857453,211988527,,3500000
Erin Brockovich,257805243,125548685,132256558,,50000000
The Village,257641634,114197520,143444114,,71682975
Rush Hour 3,256585882,140125968,116459914,44482476,180000000
Bean,256538615,45298656,211239959,,00000
Cliffhanger,255000000,84049211,170950789,,65000000
Gang jiong,254972149,1302281,253669868,,00000
Wild Hogs,253555383,168213584,85341799,92888939,60000000
Michael Jackson's This Is It,252091016,72091016,180000000,49909865,60000000
True Grit,252084251,171050328,81033923,28946093,35000000
After Earth,251499665,60522097,190977568,8531597,130000000
You've Got Mail,250710047,115731542,134978505,,65000000
Annabelle,250673813,84273813,166400000,5896893,6500000
Enemy of the State,250644445,111544445,139100000,,85000000
Hercules,250634690,99046791,151587899,,70000000
Total Recall,250585890,108580729,142005161,,65000000
Brother Bear,250397798,85336277,165061521,,00000
Space Jam,250180069,90443603,159736466,,80000000
Eragon,249488115,75030163,174457952,87829705,100000000
The Blair Witch Project,248300000,140539099,107760901,,60000
The Ring,248218486,129094024,119124462,,48000000
Unbreakable,248099143,94999143,153100000,,73243106
Love Actually,247967903,59472278,188495625,,45000000
Marley & Me,247812011,143153751,104658260,72882075,60000000
Bienvenue chez les Ch'tis,247474497,1477650,245996847,,16000000
Grown Ups 2,247023808,133668525,113355283,19238810,80000000
Dumb & Dumber,246365376,127140750,119224626,,16000000
Babe,246075470,63634380,182441090,,30000000
Lilo & Stitch,245800000,145771527,100028473,,80000000
8 Mile,245769202,116724075,129045127,,41000000
Rango,245504574,123257581,122246993,26938565,135000000
Rush Hour,245266822,141153686,104113136,,35000000
Hulk,245229234,132177234,113052000,,137000000
Back to the Future Part III,243700000,87666629,156033371,,40000000
Pixels,243566890,78747585,164819305,2525102,90000000
Hercules,243388614,72688614,170700000,9050965,100000000
Journey to the Center of the Earth,243180937,101704370,141476567,32498092,45000000
RoboCop,242981799,58607007,184374792,6750227,120000000
Four Weddings and a Funeral,242281039,52086062,190194977,,4500000
Face/Off,241197065,112273211,128923854,,80000000
Die Hard 2,239814025,117323878,122490147,,70000000
Crocodile Dundee 2,239606210,109306210,130300000,,14000000
The Girl with the Dragon Tattoo,239373970,102515793,136858177,26689474,90000000
Grand Canyon: The Hidden Secrets,239000000,52800000,186200000,,00000
Resident Evil: Retribution,238940997,42345531,196595466,15405433,65000000
Batman & Robin,238300947,107308328,130992619,,125000000
Dead Poets' Society,237966799,94326915,143639884,,16400000
Hauru no ugoku shiro,237814327,4710455,233103872,16837421,24000000
Click,237669602,137340146,100329456,81325291,82500000
Cloudy with a Chance of Meatballs,236827677,124870275,111957402,51679346,100000000
American Reunion,236799211,56758835,180040376,18653392,50000000
Dark Shadows,236527149,79727149,156800000,16789014,150000000
Silver Linings Playbook,236412453,132092958,104319495,19287059,21000000
2 Fast 2 Furious,236410607,127120058,109290549,,76000000
Artificial Intelligence: AI,235900000,78616689,157283311,,90000000
A Few Good Men,235685612,140525790,95159822,,33000000
American Pie,234723148,101800948,132922200,,12000000
Eraser,234387469,101283031,133104438,,100000000
Mr. Bean's Holiday,234268525,32589350,201679175,28542409,25000000
The Mask of Zorro,233642327,93771072,139871255,,65000000
Spy!,233125712,110825712,122300000,8180271,65000000
The Day the Earth Stood Still,233066978,79366978,153700000,33170998,80000000
Gone in 60 Seconds,232643008,101643008,131000000,,103300000
Gulliver's Travels,232017848,42779261,189238587,6938534,112000000
Million Dollar Baby,231946985,100422786,131524199,,30000000
The English Patient,231651430,78651430,153000000,,35000000
Juno,231450102,143495265,87954837,58094736,7000000
Green Lantern,231201172,116601172,114600000,22384677,200000000
The Heat,229727774,159581587,70146187,42919011,43000000
Ghost Rider,229545589,115802596,113742993,103882484,120000000
Life is Beautiful,229400000,57598247,171801753,,00000
The Green Hornet,229155503,98780042,130375461,16574350,110000000
Big Daddy,228641283,163479795,65161488,,30000000
Xia Luo Te Fan Nao,228558151,1289195,227268956,,00000
Chicken Run,227793915,106793915,121000000,,42000000
The Imitation Game,227773686,91125143,136648543,5687636,15000000
Charlie's Angels: Full Throttle,227200000,100814328,126385672,,120000000
Argo,227140757,136025503,91115254,25376346,44500000
Taken,226941585,145000989,81940596,80410606,25000000
Get Smart,226739416,130319208,96420208,37718444,80000000
Yes Man,225990976,97690976,128300000,30644446,50000000
Good Will Hunting,225839411,138339411,87500000,,10000000
Rocky,225000000,117235147,107764853,,1000000
The Social Network,224922135,96962694,127959441,24292955,40000000
It's Complicated,224614744,112735375,111879369,40222516,85000000
Sister Act,224298649,132303799,91994850,,00000
Con Air,224087161,101087161,123000000,,80000000
Jumper,223636949,81168265,142468684,36010573,82500000
Interview with the Vampire: The Vampire Chronicles,223463524,105163524,118300000,,50000000
Percy Jackson & the Olympians: The Lightning Thief,223050874,88768303,134282571,42114452,95000000
Lethal Weapon 2,221918777,141872763,80046014,,00000
"Honey, I Shrunk the Kids",221882342,129906514,91975828,,00000
Bedtime Stories,221468935,110101975,111366960,54202097,80000000
Wild Wild West,221229335,113805681,107423654,,175000000
Fahrenheit 9/11,221148959,119114517,102034442,,6000000
Constantine,221119492,75500759,145618733,,75000000
Captain Phillips,220648184,107136417,113511767,18068710,55000000
The Little Mermaid,220615965,109859444,110756521,215066949,00000
Elf,220236410,173398518,46837892,,32000000
Disney Planes,219782580,90282580,129500000,51443494,50000000
Knocked Up,219265952,148761765,70504187,121076258,27500000
Kingdom of Heaven,218853353,47398413,171454940,,110000000
The Terminal,218673959,77073959,141600000,,75000000
What Happens in Vegas...,218535708,80277646,138258062,33996136,35000000
The Prince of Egypt,218417900,101217900,117200000,,60000000
Sleepless in Seattle,218076024,116856908,101219116,,00000
The Sorcerer's Apprentice,217986320,63150991,154835329,24986039,160000000
Collateral,217670152,100170152,117500000,,60000000
Valentine's Day,217569328,110485654,107083674,20593042,52000000
Jack Reacher,217370736,80070736,137300000,13526670,60000000
Presumed Innocent,217112215,82115403,134996812,,00000
Dracula Untold,216821942,55991880,160830062,9465120,70000000
Twins,216600000,111936388,104663612,,15000000
Ted 2,215672053,81284830,134387223,,00000
Bad Teacher,215448997,100292856,115156141,13389537,19000000
The Patriot,215300000,113330342,101969658,,110000000
Australia,215080810,49554002,165526808,29479971,130000000
Just Go With It,214974953,103028109,111946844,19517101,80000000
Hansel & Gretel: Witch Hunters,214949716,55703475,159246241,12618316,50000000
Flightplan,214392904,89706988,124685916,,55000000
The Bourne Identity,214357371,121468960,92888411,,60000000
Dirty Dancing,213900000,63892689,150007311,21436063,00000
Vertical Limit,213500000,68473360,145026640,,75000000
Battle: Los Angeles,213463976,83552429,129911547,14942188,70000000
Miss Congeniality,213420951,106807667,106613284,,45000000
"Crouching Tiger, Hidden Dragon",213200000,128067808,85132192,,15000000
The Help,213120004,169705587,43414417,92679180,25000000
Ghostbusters II,213006056,110000794,103005262,,00000
Lemony Snicket's A Series of Unfortunate Events,212956024,118627117,94328907,,100000000
Master and Commander: The Far Side of the World,212912137,93926386,118985751,,135000000
Pulp Fiction,212886108,107886108,105000000,,8000000
Non-Stop,212742160,91742160,121000000,11110002,50000000
District 9,212453431,115646235,96807196,35191370,30000000
Horrible Bosses,212417601,117538559,94879042,23940693,35000000
Ace Ventura: When Nature Calls,212384285,108344348,104039937,,30000000
Public Enemies,212282709,97104620,115178089,37216384,102500000
Disclosure,212161593,82976682,129184911,,00000
End of Days,212026975,66889043,145137932,,100000000
Total Recall,211856088,58877969,152978119,13531722,125000000
Fury,211755593,85755593,126000000,13628690,80000000
Due Date,211739043,100539043,111200000,29391361,65000000
Entrapment,211700000,87707396,123992604,,66000000
Immortals,211562435,83504017,128058418,19724589,75000000
Bram Stoker's Dracula,211481986,78142084,133339902,,40000000
Moonraker,210300000,70300000,140000000,,31000000
The Expendables 3,209461378,39322544,170138834,15152291,100000000
Braveheart,209045647,75545647,133500000,,72000000
Jaws 2,208900376,102922376,105978000,,20000000
Safe House,208542162,126181630,82360532,25082420,85000000
The Aviator,208370892,102608827,105762065,,110000000
Traffic,208300000,124107476,84192524,,48000000
Garfield,208094550,75367693,132726857,,50000000
Xi you xiang mo pian,207927982,18058,207909924,205797,00000
The Others,207765056,96522687,111242369,,17000000
Clear and Present Danger,207320283,121832939,85487344,,62000000
S.W.A.T.,207154748,116877597,90277151,,70000000
Sleepy Hollow,207068340,101068340,106000000,,70000000
Eat Pray Love,206598789,80574010,126024779,39206716,60000000
The Fast and the Furious,206512310,144512310,62000000,,38000000
Red Dragon,206455420,92955420,113500000,,78000000
The Break-Up,205727307,118703275,87024032,52854244,52000000
White House Down,205440387,73103784,132336603,15537594,150000000
JFK,205400000,70405498,134994502,,40000000
Ren zai jiong tu zhi tai jiong,205400000,00000,205400000,06522,00000
Tomorrowland,205336322,93436322,111900000,3509544,170000000
Gake no ue no Ponyo,205312666,15090399,190222267,26800820,34000000
The Ugly Truth,205298907,88915214,116383693,31934968,38000000
The Holiday,205135173,63224849,141910324,73614272,85000000
Yogi Bear,204774690,100246011,104528679,17654721,80000000
Valkyrie,203902107,83077762,120824345,32510384,90000000
King Arthur,203877963,51877963,152000000,,90000000
Alien,203630630,80930630,122700000,,9000000
Into the Woods,203502372,128002372,75500000,14834293,50000000
Everest,203485569,43309450,160176119,,00000
Fun With Dick And Jane,203018919,110550000,92468919,29907987,140000000
You Don't Mess With the Zohan,202910991,100018837,102892154,35411287,90000000
Hairspray,202871849,118871849,84000000,104204647,75000000
21 Jump Street,202812429,138447667,64364762,39018831,42000000
Vanilla Sky,202726605,100614858,102111747,,70000000
Patch Adams,202173000,135014968,67158032,,50000000
Paranormal Activity 3,202053386,104028807,98024579,,5000000
Flashdance,201463574,90463574,111000000,,7000000
Percy Jackson: Sea of Monsters,200859554,68559554,132300000,25775598,90000000
Cats & Dogs,200700000,93375151,107324849,,60000000
Philadelphia,200512063,76512063,124000000,,26000000
Straight Outta Compton,200446771,161058685,39388086,,28000000
Rocky 2,200182160,85182160,115000000,,00000
Kindergarten Cop,199388425,88846113,110542312,,26000000
Two Weeks Notice,199043309,93354918,105688391,,60000000
City of Angels,198745923,78745923,120000000,,55000000
The Pacifier,198006880,113006880,85000000,,56000000
Spy Kids,197692062,112692062,85000000,,35000000
Jack the Giant Slayer,197687603,65187603,132500000,12631212,195000000
The Vow,197618160,125014030,72604130,29432338,30000000
Wallace & Gromit: The Curse of the Were-Rabbit,197593152,56068547,141524605,35106285,30000000
Red,196439693,90380162,106059531,43455873,60000000
Stargate,196346004,71346004,125000000,,55000000
50 First Dates,196324496,120776832,75547664,,75000000
Panic Room,196308367,95308367,101000000,,48000000
Anger Management,195660942,135560942,60100000,,56000000
For Your Eyes Only,195300000,54800000,140500000,,28000000
The Other Woman,195111193,83911193,111200000,11949763,40000000
Beowulf,194995215,82195215,112800000,38763948,150000000
Paranormal Activity,194183034,107918810,86264224,17205156,450000
Need for Speed,194169619,43568507,150601112,6837518,66000000
Gnomeo and Juliet,193737977,99967670,93770307,25141562,36000000
The Sum of All Fears,193500000,118471320,75028680,,68000000
The Hunt for Red October,193275519,113485385,79790134,,30000000
The Equalizer,192165283,101530738,90634545,20104995,55000000
The Addams Family,191502246,113502246,78000000,,30000000
Teenage Mutant Ninja Turtles,191369375,124635290,66734085,,13500000
Hollow Man,191200000,73209340,117990660,,90000000
Open Season,191152567,84325668,106826899,97301778,85000000
Tropic Thunder,191091250,110461307,80629943,53382052,90000000
The Longest Yard,190320568,158119460,32201108,,82000000
The Waterboy,190187252,161487252,28700000,,23000000
The Living Daylights,190111813,50096813,140015000,,40000000
Cheaper by the Dozen,189714544,138614544,51100000,,40000000
The Santa Clause,189666650,144700007,44966643,,22000000
Mr. Poppers's Penguins,189624452,68224452,121400000,24622123,55000000
The X Files: Fight the Future,189104508,83826398,105278110,,66000000
Xin Hua Lu Fang,188744961,774961,187970000,,00000
Rambo III,188715611,53715611,135000000,,58000000
Hop,188657593,108085305,80572288,43526506,63000000
The Secret Life of Walter Mitty,188536838,58236838,130300000,9107432,91000000
The Pelican Brief,187995859,100768056,87227803,,45000000
The Intern,187837061,74626709,113210352,,40000000
Walk the Line,187707495,119519402,68188093,159640925,29000000
Heat,187421778,67421778,120000000,,00000
The Final Destination,187384627,66477700,120906927,11473156,40000000
The Grudge,187097624,110175871,76921753,,10000000
The Horse Whisperer,186870763,75370763,111500000,,60000000
Knowing,186450317,79957634,106492683,24790237,50000000
Atlantis: The Lost Empire,186049020,84052762,101996258,,90000000
Paul Blart: Mall Cop,185904750,146336178,39568572,56977664,26000000
I Now Pronounce You Chuck and Larry,185708462,119725280,65983182,69502546,85000000
Inside Man,185677523,88513495,97164028,44876398,50000000
The Spy Who Loved Me,185400000,46800000,138600000,,14000000
In the Line of Fire,185113224,100013224,85100000,,00000
Snow White and the Seven Dwarfs,184925485,184925485,00000,,1488000
Watchmen,184068357,107509799,76558558,64645312,138000000
The Road to Perdition,183354514,104054514,79300000,,80000000
Aliens,183316455,85160248,98156207,,17000000
Gangs of New York,183124621,77730500,105394121,,97000000
Daredevil,182782518,102543518,80239000,,80000000
Sweet Home Alabama,182365114,127214072,55151042,,38000000
Maverick,182303917,100919952,81383965,,00000
Cape Fear,182291969,79091969,103200000,,35000000
While You Were Sleeping,182052361,81052361,101000000,,00000
Octopussy,182040579,62440579,119600000,,27500000
Jupiter Ascending,181982519,47482519,134500000,7584448,179000000
Poseidon,181674817,60674817,121000000,27225583,160000000
The Birdcage,181639840,123939840,57700000,,00000
The First Wives Club,181444419,105444419,76000000,,30000000
Jian Bing Man,181362621,00000,181362621,,00000
Scooby-Doo 2: Monsters Unleashed,181185387,84185387,97000000,,25000000
He's Just Not That Into You,181053657,93953653,87100004,30753096,40000000
Déjà Vu,181038616,64038616,117000000,40599395,80000000
12 Years a Slave,181025343,56671993,124353350,16239069,20000000
Wayne's World,180752584,119352584,61400000,,20000000
The Haunting,180188905,91188905,89000000,,80000000
The Dictator,180148897,59650222,120498675,5526222,65000000
Hugo,180047784,73864507,106183277,19201455,180000000
Flushed Away,179357126,64665672,114691454,81754608,149000000
The League of Extraordinary Gentlemen,179265204,66465204,112800000,,78000000
Moulin Rouge,179213196,57386369,121826827,,53000000
How to Lose a Guy in 10 Days,178890782,105807520,73083262,,50000000
Dangerous Minds,178778149,84778149,94000000,,00000
Scary Movie 4,178710620,90710620,88000000,23436752,40000000
Dante's Peak,178191885,67155742,111036143,,115000000
Patriot Games,178100000,83287363,94812637,,45000000
Eagle Eye,178066569,101440743,76625826,40884015,80000000
Flubber,177969824,92969824,85000000,,80000000
Double Jeopardy,177835231,116735231,61100000,,40000000
Jet Li's Hero,177535958,53652140,123883818,,17000000
Paranormal Activity 2,177512032,84752907,92759125,15727021,3000000
The A-Team,177241171,77222099,100019072,29805155,110000000
The 40 Year-old Virgin,177138471,109243478,67894993,,26000000
Lee Daniels' The Butler,177025498,116632095,60393403,24866328,30000000
Brokeback Mountain,177012173,83043761,93968412,44867223,13900000
Analyze This,176823373,106823373,70000000,,30000000
Kill Bill: Volume 1,176469428,70098138,106371290,,55000000
The Italian Job,176262839,106126012,70136827,,60000000
Hot Shots!,176251753,68251753,108000000,,00000
Tootsie,176188774,176188774,00000,,15000000
Doctor Dolittle 2,176101721,112950721,63151000,,72000000
Cowboys and Aliens,175910315,100240551,75669764,27430486,163000000
The Descendants,175507800,82624961,92882839,17968058,20000000
The Bridges of Madison County,175477088,71477088,104000000,,22000000
Identity Thief,175361578,134506920,40854658,22464546,35000000
The Bucket List,174810815,93466502,81344313,42102107,45000000
George Of The Jungle,174424566,105224566,69200000,,55000000
Le Fabuleux destin d'Amélie Poulain,174201661,33201661,141000000,,10350000
Evan Almighty,174131329,100289690,73841639,38326088,175000000
Mirror Mirror,173613482,64935167,108678315,24025417,85000000
Big Momma's House,173559438,117559438,56000000,,33000000
Along Came Polly,173044410,88073507,84970903,,42000000
Scream,173001286,103001286,70000000,,15000000
The Santa Clause 2,172825854,139225854,33600000,,65000000
AVP: Alien Vs. Predator,172543519,80281096,92262423,,70000000
Couples Retreat,172450423,109205660,63244763,38738215,60000000
Anchorman 2: The Legend Continues,172185754,127352707,44833047,7155439,50000000
Sleeping with the Enemy,171975910,98605973,73369937,,00000
Jackass 3D,171685793,117229692,54456101,18685037,20000000
Blood Diamond,171377916,57377916,114000000,62724199,100000000
Cloverfield,171302226,80048433,91253793,29308780,25000000
Mr. Deeds,171179403,126203320,44976083,,50000000
The Other Guys,170936470,119219978,51716492,38204871,100000000
Zookeeper,170805525,80360866,90444659,16108256,80000000
Meet the Robinsons,170552719,97822171,72730548,80019952,00000
Magic Mike,170549753,113721571,56828182,36743010,7000000
Looper,170466405,66486205,103980200,20666232,30000000
Starsky & Hutch,170200225,88200225,82000000,,60000000
Shi Er Sheng Xiao,169994606,00000,169994606,,00000
Superbad,169955142,121463226,48491916,136871108,17500000
Batman Begins (IMAX),169698948,15900000,153798948,,150000000
The Impossible,169590606,19019882,150570724,7057075,40000000
Unstoppable,169511609,81562942,87948667,31330161,95000000
The Saint,169392132,61355436,108036696,,90000000
The Emperor's New Groove,169296573,89296573,80000000,,100000000
Hannah Montana the Movie,169156664,79559647,89597017,61024433,30000000
Twelve Monkeys,168797229,57097229,111700000,,29000000
Four Christmases,168311558,120146040,48165518,28123876,80000000
Burn After Reading,168167798,60355347,107812451,22805461,37000000
Spy Kids 3-D: Game Over,167851995,111760631,56091364,,40000000
Xi you ji: Da nao tian gong,167840000,00000,167840000,,00000
Dodgeball: A True Underdog Story,167791704,114326736,53464968,,30000000
Alexander,167297191,34297191,133000000,,155000000
Fantastic Four,167117548,56117548,111000000,,120000000
Up in the Air,166842739,83823381,83019358,20387557,30000000
Seven Pounds,166617328,69951824,96665504,28858195,54000000
Nutty Professor II: The Klumps,166307945,123307945,43000000,,84000000
The Scorpion King,165890634,90580000,75310634,,60000000
Step Up 3D,165889117,42400223,123488894,12502105,30000000
Stuart Little 2,165779308,64736114,101043194,,120000000
Contact,165748848,100769177,64979671,,90000000
Sleepers,165600852,53300852,112300000,,44000000
Step Up Revolution,165552290,35074677,130477613,,33000000
The Princess Diaries,165334774,108244774,57090000,,30000000
Cold Mountain,165173909,95632614,69541295,,80000000
In Time,165103952,37553932,127550020,9108178,35000000
Deep Blue Sea,165048228,73648228,91400000,,60000000
"Six Days, Seven Nights",164752855,74292149,90460706,,80000000
Bringing Down the House,164675402,132675402,32000000,,20000000
Johnny English Reborn,164539660,8305970,156233690,2752495,45000000
The Grand Budapest Hotel,164350409,59076019,105274390,4480030,31000000
Daddy Day Care,164285587,104148781,60136806,,60000000
No Country for Old Men,164051250,74273505,89777745,49735357,25000000
3 Men and a Baby,164016972,164016972,00000,,15000000
Saw III,163876815,80238724,83638091,50902106,10000000
Maid in Manhattan,163838217,93932896,69905321,,55000000
Miami Vice,163790188,63450470,100339718,37743141,135000000
Pokemon: The First Movie,163644662,85744662,77900000,,30000000
World Trade Center,163295654,70278893,93016761,36986330,65000000
Unbroken,163278355,115637895,47640460,9181919,65000000
Johnny English,163126676,28013509,135113167,,45000000
The Island,163018913,35818913,127200000,,120000000
Midnight in Paris,162942835,56816662,106126173,18609766,30000000
Talladega Nights: The Ballad of Ricky Bobby,162870525,148213377,14657148,152731504,73000000
The Spiderwick Chronicles,162839667,71195053,91644614,31030005,92500000
The Happening,162778384,64506874,98271510,27977228,60000000
The Interpreter,162561036,72515360,90045676,,90000000
The Ring Two,161941727,75941727,86000000,,50000000
Insidious Chapter 2,161921515,83586447,78335068,6544088,5000000
Scream 3,161838076,89138076,72700000,,40000000
Live and Let Die,161800000,35400000,126400000,,7000000
Payback,161626121,81526121,80100000,,50000000
Memoirs of a Geisha,161510853,57010853,104500000,32863057,85000000
The Muppets,160971922,88625922,72346000,34179226,45000000
Jackass Presents: Bad Grandpa,160903019,102003019,58900000,12882139,15000000
Freaky Friday,160822438,110222438,50600000,,26000000
Alien: Resurrection,160653592,47748610,112904982,,60000000
America's Sweethearts,160648493,93607673,67040820,,46000000
Legends of the Fall,160484854,66484854,94000000,,30000000
Underworld: Awakening,160379930,62321039,98058891,18086682,70000000
27 Dresses,160245463,76806312,83439151,51498131,30000000
Hellboy II: The Golden Army,160193345,75791785,84401560,47617479,82500000
Never Say Never Again,159932841,55432841,104500000,,36000000
Black Hawk Down,159691085,108638745,51052340,9930286,95000000
Stepmom,159638444,91030827,68607617,,50000000
The Sting,159616327,159616327,00000,,5500000
Flight,159584158,93772375,65811783,21823850,31000000
Crimson Tide,159381194,91381194,68000000,,55000000
The Jackal,159310560,54910560,104400000,,60000000
The Pink Panther,158926474,82226474,76700000,23233504,80000000
Daylight,158885565,32885565,126000000,,80000000
Sin City,158753820,74103820,84650000,,40000000
The Book of Eli,158750817,94835059,63915758,42702508,80000000
The Monuments Men,158702748,78031620,80671128,14814079,70000000
Norbit,158660247,95360247,63300000,45291052,00000
The Phantom of the Opera,158225796,51225796,107000000,,55000000
Demolition Man,158168248,57168248,101000000,,00000
Dick Tracy,158098477,99098477,59000000,,47000000
Happy Feet Two,157956466,64006466,93950000,22397767,135000000
Final Destination 5,157887643,42587643,115300000,6427733,40000000
00021,157852532,81159365,76693167,28080387,35000000
The Fast and the Furious: Tokyo Drift,157693110,62514415,95178695,41275614,85000000
Unforgiven,157162710,99162710,58000000,,14400000
Lara Croft: Tomb Raider: The Cradle of Life,157092943,65653758,91439185,,90000000
This Means War,156974557,54760791,102213766,12533788,65000000
Mystic River,156822020,90135191,66686829,,30000000
War Horse,156815529,79883359,76932170,30223290,70000000
Into the Storm,156602194,47602194,109000000,6369424,50000000
Rocky Balboa,156229050,70269899,85959151,34717160,24000000
Alien 3,155933485,52360659,103572826,,55000000
Monster-in-Law,155931301,82931301,73000000,,45000000
P.S. I Love You,155769678,53695808,102073870,32777084,30000000
The Haunted Mansion,155750628,75817994,79932634,,90000000
Limitless,155564919,79249455,76315464,15301662,27000000
Under Siege,155304365,82304365,73000000,,00000
Scary Movie 3,155200000,110000082,45199918,,45000000
Dreamgirls,154965956,103365956,51600000,94993530,75000000
Licence to Kill,154697509,33197509,121500000,,42000000
Focus,154362963,53862963,100500000,4107799,65000000
Blade 2,154338601,81676888,72661713,,54000000
Beverly Hills Chihuahua,154218168,94514402,59703766,63505261,20000000
ao men feng yun 2,154130000,00000,154130000,,00000
Days of Thunder,153771268,78771268,75000000,,60000000
Ride Along,153733265,134202565,19530700,20488099,25000000
Free Willy,153698625,77698625,76000000,,00000
Kill Bill: Volume 2,153535982,66207920,87328062,,55000000
Tower Heist,153487972,78046570,75441402,16904769,85000000
Sweeney Todd: The Demon Barber of Fleet Street,153329844,52898073,100431771,40810816,00000
101 Dalmatians,153000000,153000000,00000,,00000
Devil's Advocate,152984028,60984028,92000000,,57000000
Saw II,152925093,87025093,65900000,44794875,5000000
Another 48 Hrs.,152747413,80047413,72700000,,00000
The Town,152566881,92186262,60380619,33993376,37000000
Chocolat,152500343,71309760,81190583,,25000000
Backdraft,152368585,77868585,74500000,,00000
The Taking of Pelham 123,152364370,65452312,86912058,29534860,110000000
Antz,152346554,90646554,61700000,,60000000
Date Night,152269033,98711404,53557629,25051183,55000000
A Time to Kill,152206165,108706165,43500000,,40000000
Phenomenon,152032573,104632573,47400000,,32000000
Congo,151998938,80998938,71000000,,50000000
A View to a Kill,151967091,49667091,102300000,,30000000
Evita,151894804,49994804,101900000,,55000000
47 Ronin,151659062,38362475,113296587,7282019,175000000
The Bone Collector,151463090,66488090,84975000,,48000000
Vantage Point,150886329,72266306,78620023,31656606,40000000
Olympus Has Fallen,150562164,98927592,51634572,18773158,70000000
Jack and Jill,150519217,74158157,76361060,14214011,79000000
Speed II: Cruise Control,150439315,48068396,102370919,,110000000
Mononoke-hime,150350000,2374107,147975893,,20000000
Cool Runnings,150124600,63924600,86200000,,14000000
Big,150027971,113327971,36700000,,18000000
Star Trek: First Contact,149940675,91968563,57972112,,46000000
Lone Survivor,149804632,125095601,24709031,26209615,40000000
Arthur Christmas,149717124,46462469,103254655,12518989,85000000
The General's Daughter,149705852,102705852,47000000,,60000000
"Me, Myself & Irene",149270999,90570999,58700000,,51000000
No Strings Attached,149228078,70662220,78565858,14841987,25000000
Ghost Rider: Spirit of Vengeance,149217355,51774002,97443353,12001693,57000000
Death Becomes Her,149022650,58422650,90600000,,55000000
Xi you ji zhi da sheng gui lai,148670000,00000,148670000,,00000
Seabiscuit,148634976,120197488,28437488,,86000000
Step Up 2 the Streets,148586910,58017783,90569127,26196714,17500000
Broken Arrow,148340985,70640985,77700000,,65000000
The Secret World of Arietty,148192510,19192510,129000000,15992407,00000
Gremlins,148117285,148117285,00000,,11000000
Mama,148095566,71628180,76467386,7282797,15000000
Garfield's A Tail of Two Kitties,147985373,28426747,119558626,18836320,60000000
Romeo+Juliet,147542381,46338728,101203653,,14500000
"Crazy, Stupid, Love",147142328,84351197,62791131,24428879,50000000
Swordfish,147080413,69772969,77307444,,80000000
Stand By Me Doraemon,147000000,00000,147000000,,00000
Friends with Benefits,146595891,55802754,90793137,20910874,35000000
The Game Plan,146590987,90648202,55942785,52517278,22000000
Gun dan ba! Zhong liu jun,146486639,286639,146200000,,00000
Music and Lyrics,146300356,50572589,95727767,21182037,40000000
I am Number Four,146195159,55100437,91094722,14883596,50000000
Resident Evil: Extinction,146162920,50648679,95514241,34530746,45000000
Surf's Up,145395745,58867694,86528051,46997143,100000000
Blades of Glory,145245842,118245842,27000000,52969210,61000000
The Mexican,145238250,66808615,78429635,,40000000
The Exorcism of Emily Rose,144529078,75072454,69456624,,18000000
Herbie: Fully Loaded,144110682,66010682,78100000,,50000000
New Year's Eve,143663899,54544638,89119261,11052230,26000000
Charlotte's Web,143599768,82599768,61000000,94632747,82500000
Spy Game,143049560,62362560,80687000,,90000000
Conspiracy Theory,142746226,76081498,66664728,,80000000
The Wolfman,142424154,61979680,80444474,21170629,150000000
SpongeBob SquarePants: The Movie,142051255,85416609,56634646,,30000000
Dear John,142033509,80014842,62018667,32297383,25000000
The Jungle Book,141843000,141843000,00000,270235273,00000
Legally Blonde,141809235,96493426,45315809,,18000000
National Lampoon's Animal House,141600000,141600000,00000,,3000000
Monster House,141267370,73661010,67606360,72975335,75000000
The Legend of Zorro,141256386,45356386,95900000,,80000000
The Taking of Tiger Mountain,141242964,222964,141020000,15445,00000
Bad Boys,141237842,65637842,75600000,,23000000
Dumb and Dumber To,141208010,86208010,55000000,7506310,40000000
Mona Lisa Smile,141205169,63803100,77402069,,65000000
Thunderball,141200000,63600000,77600000,,9000000
Scary Movie 2,141189101,71277420,69911681,,45000000
The Rugrats Movie,140891683,100491683,40400000,,28000000
The Devil's Own,140891572,42877165,98014407,,90000000
Source Code,140428499,54712227,85716272,10350472,32000000
The Rocky Horror Picture Show,140241017,140241017,00000,,1200000
The Jungle Book 2,140122225,47901582,92220643,,20000000
Paranormal Activity 4,140096503,53900335,86196168,7146848,5000000
Sommersby,140081992,50081992,90000000,,00000
American Graffiti,140000000,115000000,25000000,,777000
The Three Musketeers,139874484,20374484,119500000,6361158,90000000
Annie,139840525,85911262,53929263,9918340,65000000
Legend of the Guardians: The Owls of Ga'Hoole,139716717,55675313,84041404,14843530,100000000
Towering Inferno,139700000,116000000,23700000,,14000000
Anastasia,139695831,58297830,81398001,,53000000
17 Again,139474906,64167069,75307837,32368041,40000000
Trainwreck,139387096,110038130,29348966,,35000000
Star Trek: The Motion Picture,139000000,82258456,56741544,,35000000
Bird on a Wire,138697012,70978012,67719000,,00000
Nine Months,138416685,69590987,68825698,,00000
Die Hard,138398283,80639179,57759104,,28000000
Bridge to Terabithia,137984788,82234139,55750649,41497347,25000000
Contagion,137551594,75658097,61893497,13722346,60000000
Wall Street 2: Money Never Sleeps,137431619,52474616,84957003,16752742,70000000
Last Action Hero,137298489,50016394,87282095,,85000000
RED 2,137162560,53262560,83900000,28678696,84000000
Big Momma's House 2,137047376,70165972,66881404,21391039,40000000
Anaconda,136957989,65557989,71400000,,45000000
Let’s Be Cops,136890774,82390774,54500000,9372393,17000000
Stardust,136760542,38373235,98387307,27123078,70000000
Remember the Titans,136706683,115654751,21051932,,30000000
Love Story,136397186,106397186,30000000,,00000
Unknown,136123083,63686397,72436686,11769193,40000000
Lost In Space,136032598,69102910,66929688,,80000000
The Bounty Hunter,135808837,67061228,68747609,20412754,45000000
Saw IV,135759694,63300095,72459599,32443947,10000000
Cheaper by the Dozen 2,135015330,82571173,52444157,29885145,60000000
Sense and Sensibility,134975897,42975897,92000000,,16500000
The Best Exotic Marigold Hotel,134639780,46383639,88256141,18669272,10000000
Zero Dark Thirty,134612435,95720716,38891719,7649536,52500000
Pokemon 2000,133946923,43746923,90200000,,30000000
The Cat in the Hat,133818283,101018283,32800000,,109000000
Saw 3D,133735284,45710178,88025106,9660236,17000000
Perfume: The Story of a Murderer,133603463,2223293,131380170,8082799,63700000
Myeong-ryang,133450917,2830989,130619928,22564,00000
Hot Shots! Part Deux,133448689,38618836,94829853,,00000
La marche de l'empereur,133276359,77437223,55839136,,3400000
Astérix aux Jeux Olympiques,132999811,999811,132000000,,113500000
Platoon,132761962,132761962,00000,,6000000
2 Guns,132493015,75612460,56880555,12423918,61000000
Blade: Trinity,132397389,52397389,80000000,,65000000
A League of Their Own,132310685,107404544,24906141,,40000000
Babel,132121212,34302837,97818375,31475498,20000000
School of Rock,131945303,81261177,50684126,,20000000
Munich,131492772,47379090,84113682,33127910,75000000
Seven Years in Tibet,131401509,37901509,93500000,,70000000
Jack Ryan: Shadow Recruit,131377412,50577412,80800000,7451311,60000000
01408,131253353,71975611,59277742,49766172,22500000
Law Abiding Citizen,131159781,73357727,57802054,22498239,53000000
Blade,131096877,70001065,61095812,,45000000
Man on Fire,130968579,77906816,53061763,,60000000
Mean Girls,130953026,86047227,44905799,,18000000
Brüno,130788243,60054530,70733713,12011592,42000000
About a Boy,130759651,40803000,89956651,,27000000
Cloud Atlas,130673154,27108272,103564882,7737823,102000000
Walking with Dinosaurs,130580730,36076121,94504609,7880271,80000000
Star Trek IV: The Voyage Home,130396178,107109310,23286868,,24000000
"You, Me and Dupree",130228110,75628110,54600000,41744493,54000000
V for Vendetta,130214162,70511035,59703127,58827647,50000000
Bewitched,130098562,62252415,67846147,,80000000
Jingle All the Way,129813641,60573641,69240000,,60000000
Atonement,129779728,50980159,78799569,18517443,30000000
The Fighter,129262388,93617009,35645379,26281675,11000000
The Forbidden Kingdom,129075270,52075270,77000000,30654149,55000000
The Woman in Black,128955898,54333290,74622608,8920541,15000000
The Queen,128885873,56441711,72444162,29193784,15000000
Aliens vs. Predator - Requiem,128884494,41797066,87087428,29903208,40000000
Space Cowboys,128874043,90454043,38420000,,65000000
The Talented Mr. Ripley,128792135,81292135,47500000,,40000000
Nanny McPhee,128590699,47124400,81466299,42756363,25000000
Step Brothers,128468793,100468793,28000000,69306914,65000000
Failure to Launch,128402901,88715192,39687709,41413455,50000000
The Artist,128256712,44667095,83589617,10290223,16000000
Blended,127990741,46290741,81700000,11281165,45000000
Everest,127990128,87178599,40811529,,00000
Forever Young,127942530,55942530,72000000,,00000
The Heartbreak Kid,127768790,36787257,90981533,12912091,00000
Gandhi,127767889,52767889,75000000,,22000000
U-571,127630030,77086030,50544000,,62000000
An Officer and a Gentleman,127311887,127311887,00000,,00000
The Peanuts Movie,127240327,117440327,9800000,,99000000
Predators,127234389,52000688,75233701,23392033,40000000
First Knight,127027335,37027335,90000000,,75000000
The Adjustment Bureau,126931325,62495645,64435680,13593187,50200000
Smokey and the Bandit,126737428,126737428,00000,,00000
Julie & Julia,126646119,94125426,32520693,50981875,40000000
Pride & Prejudice,126549607,38372662,88176945,77689880,28000000
This is the End,126539117,101470202,25068915,7693641,32000000
American Wedding,126425115,104354205,22070910,,55000000
Space Station,126418746,93136620,33282126,,00000
Boomerang,126337168,65337168,61000000,,42000000
Sex Tape,126069509,38543473,87526036,4798181,40000000
Staying Alive,126041474,63841474,62200000,,00000
Coraline,126037057,75286229,50750828,47260765,60000000
The Dream is Alive,125900000,125900000,00000,,00000
Wolf,125486001,59486001,66000000,,70000000
I Know What You Did Last Summer,125219395,72219395,53000000,,17000000
First Blood,125212904,47212904,78000000,,14000000
Resident Evil: Apocalypse,125168734,50740078,74428656,,50000000
Fack ju Gohte 2,125000000,00000,125000000,,00000
Goldfinger,124900000,51100000,73800000,,3000000
"Legally Blonde 2: Red, White & Blonde",124868825,90168825,34700000,,25000000
Ray,124823094,75305995,49517099,,40000000
The Family Man,124715863,75764085,48951778,,60000000
Invictus,124514011,37491364,87022647,14610496,60000000
The Thomas Crown Affair,124304264,69304264,55000000,,48000000
The Pirates! Band of Misfits,124080105,31051126,93028979,5681802,55000000
Big Fish,123954323,66432867,57521456,,70000000
Hide and Seek,123696741,51100486,72596255,,25000000
Chronicle,123681790,64575175,59106615,8461360,12000000
Pan,123356994,34556994,88800000,,150000000
The Wedding Singer,123324502,80224502,43100000,,00000
The Nut Job,122529966,64251538,58278428,13911081,30000000
Save the Last Dance,122244329,91038276,31206053,,13000000
The Theory of Everything,122147772,35893537,86254235,3614871,15000000
Mortal Kombat,122123929,70423929,51700000,,20000000
The Princess Diaries 2: Royal Engagement,122071435,95149435,26922000,,45000000
Executive Decision,121872312,56472312,65400000,,55000000
Poltergeist,121706019,74706019,47000000,,10700000
Sahara,121671925,68671925,53000000,,145000000
Good Morning Vietnam,121650966,121650966,00000,,13000000
Parenthood,121619673,95369673,26250000,,00000
Intolerable Cruelty,121327628,35327628,86000000,,60000000
Apocalypto,121032272,50866635,70165637,43440938,40000000
Starship Troopers,121031113,54700065,66331048,,100000000
To Fly!,120700000,86600000,34100000,,00000
Insidious Chapter 3,120678444,52218558,68459886,1773090,10000000
Eight Below,120612565,81612565,39000000,104910627,40000000
Parental Guidance,120168633,77267296,42901337,10061390,25000000
Volcano,120027316,47474112,72553204,,90000000
Qu'est ce qu'on a fait au bon dieu,120000000,00000,120000000,,00000
Rocky V,119946358,40946358,79000000,,00000
Jeepers Creepers II,119923801,35623801,84300000,,25000000
Star Trek: Generations,119839306,75510568,44328738,,38000000
Michael,119745070,95345070,24400000,,00000
Road Trip,119739110,68525609,51213501,,16000000
Spy Kids 2: The Island of Lost Dreams,119721296,85846296,33875000,,38000000
Surrogates,119668350,38577772,81090578,12827034,80000000
Red Cliff,119627047,627047,119000000,,40000000
Charlie Wilson's War,119512771,66661095,52851676,18057601,75000000
Blazing Saddles,119500000,119500000,00000,,2600000
Rocky III,119350720,119350720,00000,,00000
The Omen,119295584,54607383,64688201,14261693,25000000
Beverly Hills Cop III,119180938,42586861,76594077,,50000000
Unfaithful,119114494,52752475,66362019,,50000000
We Bought a Zoo,118729073,75624550,43104523,27463990,50000000
On Golden Pond,118710777,118710777,00000,,00000
Barnyard: The Original Party Animals,118583844,72779000,45804844,65287926,51000000
Hua Pi 2,118528842,33212,118495630,,00000
Hotel for Dogs,118230763,73034460,45196303,33486352,75000000
Saw V,118209778,56746769,61463009,30452328,10800000
Shall We Dance?,118097882,57887882,60210000,,40000000
Kaze Tachinu,117924700,5201879,112722821,2165831,00000
Disturbia,117825354,80106701,37718653,34861608,20000000
Magic Mike XXL,117813057,66013057,51800000,6411921,14500000
Star Trek: Insurrection,117789913,70177571,47612342,,70000000
A Nightmare on Elm Street,117729621,63075011,54654610,12052379,35000000
The Client,117612663,92112663,25500000,,45000000
Blue Streak,117448157,68208190,49239967,,36000000
Dennis the Menace,117270765,51270765,66000000,,00000
The Forgotten,117211892,66711892,50500000,,50000000
Lost in Translation,117085297,44585453,72499844,,4000000
Snow Dogs,116898028,81150692,35747336,,32000000
Tian jiang xiong shi,116864070,74070,116790000,,65000000
Water for Elephants,116809717,58709717,58100000,17222920,38000000
The Siege,116623995,40932372,75691623,,70000000
The Notebook,116117340,81001787,35115553,,30000000
Pitch Perfect,116044347,65001093,51043254,85758168,17000000
City Slickers,116014390,116014390,00000,,00000
Diamonds Are Forever,116000000,43800000,72200000,,7200000
Si Ren Ding Zhi,115889225,369225,115520000,,00000
Hope Springs,115849781,63536011,52313770,13061382,30000000
Coyote Ugly,115786269,60786269,55000000,,45000000
The Iron Lady,115592104,29959436,85632668,9780361,14000000
Sliver,115524838,35524838,80000000,,00000
Closer,115476509,33987757,81488752,,35000000
Bride Wars,115150424,58715510,56434914,32129156,30000000
Warm Bodies,115121608,66380662,48740946,9251044,30000000
Romancing the Stone,115078260,75078260,40000000,,00000
Finding Neverland,115036108,51676606,63359502,,25000000
Cats & Dogs: The Revenge of Kitty Galore,114979922,45539292,69440630,11508598,85000000
Saving Mr. Banks,114962525,83299761,31662764,16317611,35000000
Lethal Weapon,114932279,59932279,55000000,,15000000
The Lake House,114830111,52330111,62500000,39933825,40000000
The Corpse Bride,114770654,53359111,61411543,,30000000
Get Shorty,114752669,71752669,43000000,,30250000
We Were Soldiers,114658262,78120196,36538066,,70000000
Freddy vs. Jason,114444496,82490748,31953748,,25000000
Changeling,113805580,35739802,78065778,13808072,55000000
Insomnia,113622499,67263182,46359317,,46000000
The Score,113542091,71069884,42472207,,68000000
Judge Dredd,113487912,34687912,78800000,,85000000
Underworld: Evolution,113417762,62318875,51098887,61779449,45000000
Prisoners,113402302,61002302,52400000,11120474,46000000
Arthur et les Minimoys,113325743,15132763,98192980,13207376,80000000
Species,113300401,60000401,53300000,,35000000
The Reader,113019290,34194407,78824883,13142221,32500000
Striptease,112958418,32758418,80200000,,50000000
Goosebumps,112941981,77751657,35190324,,58000000
Last Vegas,112914167,63914167,49000000,9347402,28000000
Final Destination 3,112798051,54098051,58700000,18695596,25000000
The Tooth Fairy,112610386,60022256,52588130,22311926,48000000
Where Are We Going Dad?,112370000,00000,112370000,,00000
Rambo,112214531,42754105,69460426,40599674,47500000
Final Destination,112036870,53302314,58734556,,23000000
Frankenstein,112006296,22006296,90000000,,45000000
The Pianist,111854182,32519322,79334860,,35000000
Doctor Zhivago,111745581,111721000,24581,,11000000
You Only Live Twice,111600000,43100000,68500000,,9500000
The Purge: Anarchy,111533636,71562550,39971086,6940145,9000000
White Chicks,111448997,69148997,42300000,,20000000
Moneyball,111300835,75605492,35695343,24422077,50000000
Step Up,110989157,65328121,45661036,51838222,12000000
"The Karate Kid, Part II",110722495,110722495,00000,,00000
Seventh Son,110623265,17223265,93400000,4126551,95000000
L.A. Confidential,110604977,64604977,46000000,,35000000
The Net,110520117,50620117,59900000,,22000000
Lang Tu Teng,110460000,00000,110460000,,00000
Free Birds,110387072,55750480,54636592,13167490,55000000
Casino,110349860,42388160,67961700,,52000000
Peter Pan: Return to Neverland,109855792,48423368,61432424,,20000000
The Dukes of Hazzard,109848461,80270227,29578234,,53000000
Sideways,109793192,71502303,38290889,,17000000
Hoodwinked,109678446,51221667,58456779,31482113,17500000
Abraham Lincoln: Vampire Hunter,109471676,37519139,71952537,9251696,67500000
Män som hatar kvinnor,109421911,12749992,96671919,5643654,13000000
Fool's Gold,109362966,70231041,39131925,21487320,72500000
The Boxtrolls,109285033,50837305,58447728,8181522,60000000
Billy Elliot,109280263,21995263,87285000,,5000000
Earth,109011576,32011576,77000000,18946344,15000000
Planet 51,108996113,42194060,66802053,17229957,60000000
One Flew Over the Cuckoo's Nest,108981275,108981275,00000,,4400000
The Amityville Horror,108800304,64858000,43942304,,18500000
Pompeii,108469033,23169033,85300000,3954773,80000000
Body of Lies,108394666,39394666,69000000,23033447,67500000
Junior,108387600,36719600,71668000,,00000
Confessions of a Shopaholic,108027701,44277350,63750351,19455460,00000
The American President,107809496,60009496,47800000,,62000000
The Texas Chainsaw Massacre,107785686,80390022,27395664,,9000000
Three Kings,107752036,60652036,47100000,,48000000
Paul Blart: Mall Cop 2,107597242,71038190,36559052,7685408,38000000
ParaNorman,107593122,56003051,51590071,15967511,60000000
The Santa Clause 3: The Escape Clause,107500122,84500122,23000000,77158306,00000
Hidalgo,107336658,67286731,40049927,,78000000
Transporter 3,107235592,31715062,75520530,21351444,00000
The Chronicles of Riddick,107212751,57712751,49500000,,120000000
Shaft,107190108,70327868,36862240,,53012938
About Schmidt,107054484,65005217,42049267,,30000000
The Breakup Guru,106798959,208959,106590000,,00000
Ace Ventura: Pet Detective,106602138,71602138,35000000,,12000000
Made of Honor,106548738,46012734,60536004,20177652,40000000
Spirit: Stallion of the Cimarron,106515310,73215310,33300000,,80000000
Get Hard,106511453,90411453,16100000,15110967,40000000
Jiu ceng yao ta,106380000,00000,106380000,,00000
Mr. Holland's Opus,106165254,82465254,23700000,,00000
Mission to Mars,106000000,60874615,45125385,,90000000
Horrible Bosses 2,105945357,54445357,51500000,4863342,40000000
Life as We Know It,105887837,53374681,52513156,22132611,38000000
The Man From U.N.C.L.E.,105445109,45445109,60000000,,75000000
The Brothers Grimm,105299638,37899638,67400000,,80000000
Hereafter,105246941,32746941,72500000,7662274,50000000
Terms of Endearment,105237012,105237012,00000,,00000
Along Came a Spider,105159085,74058698,31100387,,28000000
Porky's,105124546,105124546,00000,,4000000
Race to Witch Mountain,105103783,67172594,37931189,36693713,50000000
Cinderella Man,105021488,61649911,43371577,,88000000
Chappie,105002056,31569268,73432788,6299759,49000000
Made In America,104942695,44942695,60000000,,00000
Forgetting Sarah Marshall,104932954,62932375,42000579,39087097,30000000
The Campaign,104907746,86907746,18000000,17214034,95000000
Training Day,104505362,76261036,28244326,,45000000
Vicky Cristina Barcelona,104504817,23216709,81288108,10429870,16000000
Don't Say a Word,104488383,54997476,49490907,,50000000
The Tuxedo,104429625,50586000,53843625,,60000000
The Prestige,104407366,53089891,51317475,46041455,40000000
The Graduate,104397102,104397102,00000,,00000
Dragonheart,104317350,51317350,53000000,,57000000
Under Siege 2: Dark Territory,104302097,50002097,54300000,,60000000
Sanctum,104283753,23209310,81074443,3238179,30000000
Every Which Way but Loose,104268727,104268727,00000,,00000
Eyes Wide Shut,104213915,55637680,48576235,,65000000
Gangster Squad,104100903,46000903,58100000,9437743,60000000
Snake Eyes,103885389,55585389,48300000,,73000000
Saw,103880027,55968727,47911300,,1200000
Escape Plan,103735965,25135965,78600000,9230834,70000000
Ouija,103474009,50856010,52617999,5878220,5000000
Dawn of the Dead,103452875,58990765,44462110,,28000000
Rugrats in Paris,103284813,76501438,26783375,,30000000
Birdman or (The Unexpected Virtue of Ignorance),103240598,42340598,60900000,2934986,18000000
Resident Evil,103200000,39532308,63667692,,35000000
Gukjesijang,103048677,2305912,100742765,,00000
T-Rex: Back to the Cretaceous,103043249,53743249,49300000,,00000
Transcendence,103039258,23022309,80016949,3603059,100000000
Project X,103028188,54731865,48296323,15963989,12000000
Jimmy Neutron: Boy Genius,102992536,80936232,22056304,,25000000
Blue Jasmine,102912961,33404871,69508090,3291759,18000000
My Bloody Valentine,102836002,51545952,51290050,21641751,14000000
The Hitchhiker's Guide to the Galaxy,102746214,51019112,51727102,,45000000
The Cable Guy,102739932,60154431,42585501,,47000000
Love and Other Drugs,102719647,32367005,70352642,16038172,30000000
Driving Miss Daisy,102647257,102647257,00000,,7500000
The Water Horse: Legend of the Deep,102537899,40412817,62125082,30606394,00000
Primal Fear,102513000,56013000,46500000,,00000
Ghosts of Girlfriends Past,102512802,55250026,47262776,24651243,00000
The Pineapple Express,102404019,87341380,15062639,48748925,26000000
Ladder 49,102332848,74541707,27791141,,60000000
The Time Traveler's Wife,102332135,63414846,38917289,23203865,39000000
Butch Cassidy and the Sundance Kid,102308900,102308900,00000,,6000000
Mary Poppins,102300000,102300000,00000,,6000000
Zombieland,102236596,75590286,26646310,39374623,23600000
John Q,102226631,71026631,31200000,,36000000
Kung Fu Hustle,102034104,17104669,84929435,,20000000
The Devil Inside,101758489,53261944,48496545,2674672,1000000
Just Married,101564935,56127162,45437773,,19000000
Timecop,101527925,44327925,57200000,,28000000
Miss Congeniality 2: Armed and Fabulous,101382396,48478006,52904390,,60000000
Mars Attacks!,101354208,37754208,63600000,,80000000
Superman II,101347629,101347629,00000,,54000000
Scream 2,101334374,101334374,00000,,24000000
Stir Crazy,101300000,101300000,00000,,00000
Little Man,101295702,58295702,43000000,33291545,64000000
Crash,101173038,55334418,45838620,,7303082
Guess Who,101162333,67962333,33200000,,35000000
Paul,101162106,37412945,63749161,11368253,40000000
Heaven is for Real,100919111,91386097,9533014,27366791,12000000
Fight Club,100853753,37030102,63823651,,65000000
Courage Under Fire,100748262,58918501,41829761,,46000000
Just Like Heaven,100687083,48318130,52368953,37741022,58000000
Vacation,100655793,58884188,41771605,,31000000
Little Miss Sunshine,100642353,59891098,40751255,55516489,8000000
A Knight’s Tale,100622586,56083966,44538620,,41000000
Up Close & Personal,100584674,50984674,49600000,,60000000
Airport,100489150,100489150,00000,,00000
No se Aceptan Devoluciones,100486616,44467206,56019410,5190072,5000000
Nine to Five,100409707,100409707,00000,,00000
Any Given Sunday,100230832,75530832,24700000,,60000000
Hou hui wu qi,100110000,00000,100110000,,00000
Zhi wo men zhong jiang shi qu de qing chun,100030000,00000,100030000,,00000
The Good Shepherd,99908565,59908565,40000000,33898478,00000
Insidious,99870886,54009150,45861736,10910455,1500000
Mad Max,99750000,8750000,91000000,,200000
The Wild,99384046,37384046,62000000,43205003,80000000
Hellboy,99303901,59103901,40200000,,60000000
Nacho Libre,99296462,80197993,19098469,47079066,32000000
Street Fighter,99210975,33210975,66000000,,35000000
Hitman,99135571,39687694,59447877,34060690,17500000
Where the Wild Things Are,99123656,77233467,21890189,29627080,100000000
Justin Bieber: Never Say Never,99034125,73013910,26020215,26785449,13000000
The Time Machine,98983590,56684819,42298771,,80000000
Kramer vs. Kramer,98982763,98982763,00000,,00000
Philomena,98963392,37709979,61253413,6184743,12000000
The Last Witch Hunter,98837760,26992783,71844977,,80000000
Paycheck,98819789,53789313,45030476,,60000000
Heaven Can Wait,98800000,98800000,00000,,00000
Les Visiteurs,98754000,659000,98095000,,7000000
Bowfinger,98606290,66365290,32241000,,55000000
Contraband,98406855,66528000,31878855,16971353,25000000
French Kiss,98373158,38843026,59530132,,00000
Evolution,98341932,38311134,60030798,,80000000
Rush,98230839,26947624,71283215,4461821,38000000
Billy Jack,98000000,98000000,00000,,00000
Fred Claus,97837638,72006777,25830861,33790568,00000
Phone Booth,97837138,46566212,51270926,,11000000
Evil Dead,97778356,54239856,43538500,7796677,17000000
Are We There Yet?,97741594,82301521,15440073,,20000000
The Thin Red Line,97694306,36385763,61308543,,52000000
The Book of Life,97651543,50151543,47500000,10228780,50000000
Nanny McPhee and the Big Bang,97613438,29011215,68602223,10864759,35000000
The Man with the Golden Gun,97600000,21000000,76600000,,7000000
Kick-Ass,97531134,48071303,49459831,23755925,28000000
00042,97470701,95020213,2450488,21710838,40000000
Once Upon a Time in Mexico,97413527,56330657,41082870,,29000000
Inspector Gadget,97360069,97360069,00000,,75000000
The Rite,97143987,33047633,64096354,6418055,37000000
Green Zone,97079343,35053660,62025683,17581801,100000000
Enemy at the Gates,96971293,51396781,45574512,,85000000
The Hours,96952304,41597830,55354474,,25000000
Jarhead,96947540,62647540,34300000,52373154,72000000
Star Trek VI: The Undiscovered Country,96900000,74888996,22011004,,27000000
My Sister's Keeper,96673002,49200230,47472772,23550853,27500000
Red Eye,96666486,57891803,38774683,,26000000
Planes: Fire and Rescue,96657732,59157732,37500000,15391618,50000000
The Lucky One,96633833,60457138,36176695,26231698,25000000
Di Renjie zhi shendu longwang,96487783,87783,96400000,169344,00000
Christmas with the Kranks,96469187,73701902,22767285,,50000000
13 Going On 30,96439723,57139723,39300000,,30000000
8MM,96238885,36283501,59955384,,40000000
The Stepford Wives,96221971,59475623,36746348,,100000000
Think Like a Man,96155124,91547205,4607919,17055721,12000000
The Manchurian Candidate,96148711,65948711,30200000,,80000000
The Tigger Movie,96147688,45542421,50605267,,20000000
TMNT,96096018,54149098,41946920,31001626,35000000
Dolphin Tale,96068724,72286779,23781945,33655311,37000000
The 6th Day,96024898,34543701,61481197,,82000000
Scream 4,95989590,38180928,57808662,4780888,40000000
Poltergeist,95825125,47425125,48400000,2088402,35000000
The Visit,95749084,65112020,30637064,,5000000
Underworld,95708457,51970690,43737767,,22000000
Shooter,95703582,47003582,48700000,57607577,60000000
The Butterfly Effect,95638592,57924679,37713913,,13000000
P.K.,95616104,10616104,85000000,,00000
Killers,95572749,47059963,48512786,17840365,75000000
Star Trek II: The Wrath of Khan,95520578,78633541,16887037,,12000000
Bridge of Spies,95343009,67743009,27600000,,40000000
Peter Pan,95255485,48417850,46837635,,100000000
Harlem Nights,95135854,60135854,35000000,,00000
Old Dogs,95104304,49492060,45612244,25135658,35000000
40 Days and 40 Nights,95092667,37939782,57152885,,17000000
Be Cool,94944017,55849401,39094616,,75000000
HouseSitter,94900635,58500635,36400000,,00000
01941,94875000,34175000,60700000,,32000000
The Lovely Bones,94808454,44028238,50780216,11482174,95000000
Riddick,94763758,42025135,52738623,13362096,38000000
The Wedding Planner,94728529,60400856,34327673,,28000000
Silent Hill,94704227,46982632,47721595,22943587,50000000
Saat po long 2,94693927,00000,94693927,,00000
Predator,94604507,56072497,38532010,,18000000
Role Models,94494141,67294270,27199871,40530892,28000000
The Hundred-Foot Journey,94270488,54235441,40035047,12762627,22000000
Nim's Island,94081683,48006762,46074921,21204675,37000000
Safe Haven,94050951,71399120,22651831,19641113,28000000
Cong cong na nian,94036853,566853,93470000,,00000
Forces of Nature,93900680,52900680,41000000,,00000
The River Wild,93851705,46451705,47400000,,45000000
Jin líng shí san chai,93721434,311434,93410000,1263245,100000000
The Internship,93672764,44672764,49000000,6781996,58000000
Downfall,93631744,5501940,88129804,,13500000
Lady and the Tramp,93600000,93600000,00000,130363759,00000
The Color Purple,93589701,93589701,00000,,15000000
Speed Racer,93394462,43945766,49448696,22469785,120000000
The Poseidon Adventure,93300000,93300000,00000,,00000
Calendar Girls,93074616,31011616,62063000,,00000
Michael Clayton,92987651,49033882,43953769,20195679,21500000
Deuce Bigalow: Male Gigolo,92935067,65535067,27400000,,18000000
House of Flying Daggers,92863945,11050094,81813851,,12000000
Syriana,92690959,50824620,41866339,15419077,50000000
The Last Song,92678948,62950384,29728564,38121141,20000000
Friday the 13th,92670237,65002019,27668218,10344904,17000000
Gwoemul,92618117,2201923,90416194,,12000000
I Am Sam,92542418,40270895,52271523,,22000000
Four Brothers,92494381,74494381,18000000,,30000000
The Family Stone,92357499,60062868,32294631,24192868,18000000
The Skeleton Key,92155498,47806295,44349203,,40000000
Secret Window,92111551,47958031,44153520,,40000000
Tammy,92025432,84525432,7500000,11689240,20000000
No Reservations,91943956,43107979,48835977,27243419,28000000
White Noise,91865715,55865715,36000000,,10000000
Treasure Planet,91800000,38120554,53679446,,100000000
When Harry Met Sally…,91744616,91744616,00000,,16000000
"I Love You, Man",91729503,71440011,20289492,31213759,40000000
Masquerade,91593744,15855828,75737916,,00000
Drag Me To Hell,91388487,42100625,49287862,15760398,30000000
Get Him to the Greek,91276824,60974475,30302349,25395881,40000000
The Purge,91265155,64473115,26792040,7404987,3000000
Season of the Witch,91126600,24827228,66299372,7395836,40000000
Romeo Must Die,91036760,55973336,35063424,,25000000
"Gwanghae, Wangyidoen namja",90913144,922921,89990223,,00000
Assassination,90904682,1904682,89000000,,00000
The Karate Kid,90815558,90815558,00000,,8000000
White Men Can't Jump,90753806,76253806,14500000,,00000
Kangaroo Jack,90723216,66723216,24000000,,60000000
Autumn in New York,90717684,37752931,52964753,,40000000
King Kong,90614445,52614445,38000000,,23000000
Galaxy Quest,90523726,71423726,19100000,,45000000
Madea Goes To Jail,90508336,90508336,00000,30336627,17500000
Veteran,90496886,1155652,89341234,,00000
The Tale of Despereaux,90482317,50877145,39605172,27452865,60000000
Bring it On,90453550,68353550,22100000,,10000000
Final Destination 2,90396664,46896664,43500000,,26000000
Bedazzled,90376224,37879996,52496228,,48000000
Red Riding Hood,90300442,37662162,52638280,7634872,42000000
This is 40,90221182,67544505,22676677,12128464,35000000
Black Mass,90070207,62570207,27500000,,53000000
Mysteries of Egypt,90000000,40593286,49406714,,00000
Rien a declarer,89934733,182295,89752438,,00000
Sucker Punch,89758389,36392502,53365887,8977930,75000000
Ender's Game,89737191,61737191,28000000,13272966,110000000
Burlesque,89657398,39440655,50216743,33377414,55000000
Anchorman: The Legend of Ron Burgundy,89476265,84136909,5339356,,25000000
Stigmata,89441732,50041732,39400000,,32000000
Racing Stripes,89369889,49186871,40183018,,30000000
Father of the Bride,89325780,89325780,00000,,00000
Fracture,89204700,39004700,50200000,22352497,00000
About Time,89177486,15323921,73853565,9209057,12000000
Underworld 3: Rise of the Lycans,89102315,45802315,43300000,46759194,35000000
The Trial of Billy Jack,89000000,89000000,00000,,00000
The Transporter 2,88978202,43095600,45882602,,32000000
Steel Magnolias,88961388,77568541,11392847,,00000
Rumor Has It,88933562,42996140,45937422,21046244,00000
State of Play,88832210,37017955,51814255,17012451,60000000
Trading Places,88621914,88621914,00000,,00000
La Môme,88611837,10299782,78312055,,15500000
The Cider House Rules,88547209,57547209,31000000,,00000
Brave Hearts Umizaru,88331372,00000,88331372,,00000
Shanghai Knights,88316835,60470220,27846615,,50000000
The Hand That Rocks the Cradle,88036683,88036683,00000,,00000
Match Point,87989926,23089926,64900000,12299614,15000000
Southpaw,87982196,52421953,35560243,1316562,30000000
Deliver Us from Evil,87956618,30577122,57379496,2940608,30000000
Spawn,87937226,54967359,32969867,,40000000
Deep Sea 3D,87923097,46144915,41778182,2513653,00000
Sinister,87727807,48086903,39640904,10496520,3000000
Ali,87683966,58183966,29500000,,109000000
Bicentennial Man,87420776,58220776,29200000,,90000000
Peter Pan,87400000,87400000,00000,91017803,4000000
R.V.,87252035,71452035,15800000,32203241,55000000
Volver,87226613,12899867,74326746,,9400000
Hall Pass,87173475,45060734,42112741,8103250,68000000
The Lincoln Lawyer,87145086,58009200,29135886,14050992,40000000
The Shaggy Dog,87123569,61123569,26000000,28724132,60000000
Sabrina,87100000,53458319,33641681,,58000000
The Good Dinosaur,87092056,58392056,28700000,,187500000
El Laberinto del Fauno,87041569,37634615,49406954,49417898,16000000
Wolf Warriors,87024061,00000,87024061,55968,00000
The Guardian,87011732,55011732,32000000,54197634,00000
Dodookdeul,86960532,532699,86427833,,00000
Epic Movie,86858578,39739367,47119211,16909634,20000000
Dinner for Schmucks,86796502,73026337,13770165,13942663,69000000
Oceans,86787530,19422319,67365211,4771125,80000000
Old School,86765463,75155000,11610463,,24000000
A Million Ways to Die in The West,86760995,42720965,44040030,7686721,40000000
Abduction,86648359,28087155,58561204,7702870,35000000
Back to School,86611121,86611121,00000,,00000
Rat Race,86607223,56607223,30000000,,48000000
The Kingdom,86509602,47467250,39042352,35611833,72500000
The Amityville Horror,86432520,86432520,00000,,00000
Paranormal Activity: The Marked Ones,86362372,32462372,53900000,1366427,5000000
Jing cha gu shi er ling yi san,86340000,00000,86340000,,00000
The Constant Gardener,86301599,33579798,52721801,,25500000
Young Frankenstein,86300000,86300000,00000,16803532,2800000
"Alexander and the Terrible, Horrible, No Good, Very Bad Day",86254149,66954149,19300000,10408716,28000000
The Inbetweeners,86051320,35955,86015365,,5700000
The Cell,85911226,61280963,24630263,,35000000
Max Payne,85761789,40687294,45074495,26838399,35000000
The Naked Gun 2½: The Smell of Fear,85748264,85748264,00000,,23000000
Tears of the Sun,85632458,43632458,42000000,,75000000
The Whole Nine Yards,85527867,57262492,28265375,,24000000
Rookies,85405510,00000,85405510,,00000
Jackass: Number Two,85278712,72778712,12500000,64269993,11000000
Date Movie,85146165,48548426,36597739,18901710,20000000
Final Fantasy: The Spirits Within,85131830,32131830,53000000,,137000000
Long men fei jia,85130718,170276,84960442,,00000
7beonbangui Seonmool,85000227,00000,85000227,,00000
Das Boot,84915795,11433134,73482661,,12000000
Meet the Spartans,84646831,38233676,46413155,16958378,30000000
J. Edgar,84606030,37306030,47300000,9456045,35000000
Du cheng feng yun,84570000,00000,84570000,,00000
The Grey,84339696,51580136,32759560,13471266,25000000
Pinocchio,84300000,84300000,00000,,00000
The Second Best Exotic Marigold Hotel,84278266,33078266,51200000,2981961,00000
Priest,84154026,29136626,55017400,6571298,60000000
Marmaduke,84023611,33644788,50378823,17173899,50000000
The Parent Trap,83972995,66304095,17668900,,00000
Les Bronzés 3: amis pour la vie,83833602,00000,83833602,,42000000
The Illusionist,83792062,39868642,43923420,38239483,16500000
The Goodbye Girl,83700000,83700000,00000,,00000
Piranha 3D,83660160,25003155,58657005,6057986,24000000
Snatch,83593107,30093107,53500000,,10000000
Point Break,83531958,43218387,40313571,,24000000
Les Choristes,83529758,3629758,79900000,,5500000
Airplane!,83453539,83453539,00000,,3500000
Stripes,83339362,83339362,00000,,10000000
Fantasia,83320000,83320000,00000,,2280000
Blow,83282296,52990775,30291521,,30000000
Assassins,83272938,30272938,53000000,,50000000
In & Out,83226569,63826569,19400000,,35000000
The War of the Roses,83216475,83216475,00000,,00000
Sky High,83109359,63939454,19169905,,35000000
Dead Man Walking,83080768,39379757,43701011,,11000000
Zodiac,83080084,33080084,50000000,21139119,85000000
The Strangers,83051676,52597610,30454066,23321086,9000000
B_ij_ng yù shàng xi y_ tú,82984614,00000,82984614,,00000
28 Days Later...,82955633,45064915,37890718,,8000000
The Possession,82925064,49130588,33794476,7387560,14000000
Edge of Darkness,82812456,43313890,39498566,14117341,60000000
Firewall,82751189,48751189,34000000,23300653,50000000
Shaun the Sheep,82625982,19375982,63250000,,00000
Act of Valor,82497035,70012847,12484188,27955265,12000000
Carrie,82409520,35266619,47142901,4323294,30000000
Paper Towns,82400304,32000304,50400000,902536,00000
Men of Honor,82339483,48814909,33524574,,32000000
"Big Mommas: Like Father, Like Son",82332450,37915414,44417036,3937152,32000000
Hostel,82241110,47326473,34914637,23868559,4800000
In Her Shoes,82203030,32880591,49322439,,00000
Identity,82183683,52131264,30052419,,28000000
Reign of Fire,82150183,43061982,39088201,,60000000
Letters to Juliet,82148538,53032453,29116085,33091362,30000000
Catwoman,82145379,40202379,41943000,,100000000
Elizabeth,82080933,30012990,52067943,,25000000
On Her Majesty's Secret Service,82000000,22800000,59200000,,8000000
The Land Before Time,81972846,48092846,33880000,,12300000
Hitman: Agent 47,81967450,22467450,59500000,,00000
Star Trek III: The Search for Spock,81802739,71273785,10528954,,18000000
Hot Fuzz,81742618,23618786,58123832,33474968,16000000
Midnight Run,81613606,38413606,43200000,,30000000
M*A*S*H,81600000,81600000,00000,,3500000
Premonition,81461343,47852604,33608739,33639542,20000000
Tinker Tailor Soldier Spy,81452811,24149393,57303418,5543087,21000000
Hope Floats,81452467,60033780,21418687,,30000000
Vampires Suck,81424988,36661504,44763484,10624488,20000000
Waiting to Exhale,81347948,66947948,14400000,,00000
Yi bu zhi yao,81300000,00000,81300000,,00000
Pain & Gain,81275291,49875291,31400000,10491569,26000000
Dying Young,81264473,32669178,48595295,,00000
Apocalypse Now,81250488,78800000,2450488,3520141,31500000
Police Academy,81198894,81198894,00000,,4500000
Das Leben der Anderen,81197047,11284657,69912390,4417786,2000000
Snowpiercer,81185948,4563029,76622919,1810083,40000000
Frankenweenie,81150788,35287788,45863000,17489680,39000000
Duplicity,81079566,40572825,40506741,11564909,60000000
The Rundown,80831893,47641743,33190150,,85000000
Arthur,80803852,80803852,00000,,00000
Sinbad: Legend of the Seven Seas,80767884,26483452,54284432,,60000000
Spy Kids: All the Time in the World,80681183,38536376,42144807,,27000000
What to Expect When You're Expecting,80652203,41152203,39500000,6312299,37500000
Hannibal Rising,80583311,27669725,52913586,23515108,50000000
Fiddler on the Roof,80500000,80500000,00000,,9000000
The Rookie,80491516,75600072,4891444,,22000000
Did You Hear About the Morgans?,80480566,29580087,50900479,9311023,58000000
The Game,80369970,48265581,32104389,,50000000
30 Days of Night,80276156,39568996,40707160,27959479,30000000
Fame,80227619,22455510,57772109,5489768,18000000
The Wedding Ringer,80171596,64460211,15711385,3673158,00000
Finding Forrester,80013623,51768623,28245000,,43000000
The Ten Commandments,80000000,80000000,00000,,13500000
Exit Wounds,79958599,51758599,28200000,,33000000
D-War,79915361,10977721,68937640,7654068,32000000
Earthquake,79700000,79700000,00000,,00000
Revolutionary Road,79564960,22911480,56653480,8355425,45000000
"Goodbye, Lenin!",79384539,4063859,75320680,,6400000
Nights in Rodanthe,79350659,41850659,37500000,18266752,00000
Muppets Most Wanted,79312301,51178893,28133408,6154950,55000000
Jackass: The Movie,79282312,64282312,15000000,,5000000
El orfanato,79250193,7159147,72091046,7575062,4000000
Tiny Times 4.0,79230000,00000,79230000,,00000
Conan the Barbarian,79114085,38264085,40850000,,20000000
R.I.P.D.,79072464,33618855,45453609,7291588,130000000
Savages,79020056,47323100,31696956,10341513,45000000
Showtime,78948765,37948765,41000000,,85000000
From Russia With Love,78900000,24800000,54100000,,2000000
If I Stay,78874843,50474843,28400000,9529314,11000000
Fried Green Tomatoes,78874364,78874364,00000,,00000
The Haunting in Connecticut,78758522,55389516,23369006,29618382,00000
Skyline,78670636,21393620,57277016,8874724,10000000
Scary Movie V,78613981,32015787,46598194,3812097,20000000
Righteous Kill,78481410,40081410,38400000,17857427,60000000
Collateral Damage,78353508,40048332,38305176,,85000000
Orphan,78337373,41596251,36741122,15461200,20000000
Gothika,78280896,59588068,18692828,,00000
The Other Boleyn Girl,78269970,26814957,51455013,9880637,40000000
Cocktail,78222753,78222753,00000,,00000
The Unborn,78208812,42670410,35538402,11828987,16000000
The Sentinel,78080697,36280697,41800000,21100889,60000000
Drive,78054825,35060689,42994136,10660132,15000000
Zuo Er,77910000,00000,77910000,,00000
Step Up All In,77804384,14904384,62900000,2376375,00000
The Ides of March,77735925,40962534,36773391,7759933,23000000
Hostage,77636443,34636443,43000000,,75000000
Windtalkers,77628265,40914068,36714197,,115000000
The Number 23,77593167,35193167,42400000,27797551,32000000
The Golden Child,77559863,77559863,00000,,12000000
United 93,77551351,31483450,46067901,17925518,18000000
Halloween,77514401,58269151,19245250,39424010,15000000
Ocho Apellidos Vascos,77497478,00000,77497478,,00000
Paranormal Activity: The Ghost Dimension,77497124,18297124,59200000,,00000
Out of Sight,77474810,37474810,40000000,,48000000
The Ladykillers,77392139,39692139,37700000,,35000000
Something to Talk About,77277438,50835801,26441637,,00000
Diary of a Wimpy Kid: Dog Days,77229695,49008662,28221033,16148981,22000000
Mirrors,77220596,30691439,46529157,10539324,35000000
There Will Be Blood,77208711,40222514,36986197,25238313,25000000
Money Train,77205090,35305090,41900000,,68000000
Bad Santa,77147031,60060328,17086703,,18000000
Barbershop,77063461,75781642,1281819,,12000000
Moonstruck,77051120,77051120,00000,,00000
Byeon-ho-in,76988372,00000,76988372,,00000
Diary of a Wimpy Kid,76954311,64003625,12950686,41055350,15000000
The Terminator,76953296,36953296,40000000,,6400000
Bajrangi Bhaijaan,76863557,8178001,68685556,,00000
Coach Carter,76665507,67264877,9400630,,45000000
The Muppet Movie,76657000,76657000,00000,,8000000
Father of the Bride Part II,76578911,76578911,00000,,00000
Home on the Range,76482461,50026353,26456108,,110000000
The Mechanic,76347393,29121498,47225895,12580670,42500000
Teenage Mutant Ninja Turtles II: The Secret of the Ooze,76323571,76323571,00000,,25000000
John Wick,76237835,43037835,33200000,10137978,00000
Easy A,76200721,58401464,17799257,25561356,8000000
The Judge,76119388,47119388,29000000,7478097,50000000
The Book Thief,76086711,21488481,54598230,11341986,19000000
Stealth,76004416,31704416,44300000,,138000000
The Mortal Instruments: City of Bones,75965567,31165421,44800146,9945105,60000000
48 Hrs.,75936265,75936265,00000,,00000
Cocoon,75901168,75901168,00000,,00000
Sicario,75869990,46092063,29777927,,30000000
Tin Cup,75854588,53854588,22000000,,45000000
Footloose,75846770,75846770,00000,,8200000
The Change-Up,75835124,37081475,38753649,16584843,52000000
Cruel Intentions,75775536,38201895,37573641,,11000000
"O Brother, Where Art Thou?",75763814,45506619,30257195,,26000000
The Untouchables,75729280,75729280,00000,,25000000
Dreamcatcher,75685268,33685268,42000000,,68000000
Man cheng jin dai huang jin jia,75566773,6566773,69000000,10619284,45000000
Stomp the Yard,75525718,61356221,14169497,33547473,14000000
Xiao shi dai 3,75490000,00000,75490000,,00000
The Count of Monte Cristo,75389090,54228104,21160986,,40000000
Serendipity,75294136,50255310,25038826,,28000000
The Back-up Plan,75281179,37490007,37791172,12633149,35000000
Elizabeth: The Golden Age,74870866,16285240,58585626,9936935,55000000
The Prince of Tides,74787599,74787599,00000,,30000000
Jackie Brown,74701925,39647595,35054330,,12000000
"I, Frankenstein",74575290,19075290,55500000,7396348,65000000
Bend it Like Beckham,74566042,32543449,42022593,,5600000
WarGames,74433837,74433837,00000,,12000000
To Rome with Love,74363777,16684352,57679425,,21500000
The Kite Runner,74180745,15800078,58380667,8396215,20000000
Escape From Planet Earth,74156610,57012977,17143633,5778512,40000000
The Core,74132631,31111260,43021371,,85000000
Crimson Peak,74048222,31090320,42957902,,00000
Obsessed,73964713,68261644,5703069,20882727,20000000
The Hurricane,73956241,50699241,23257000,,38000000
The Divine Secrets of the Ya-Ya Sisterhood,73826768,69586544,4240224,,27000000
Diary of a Wimpy Kid: Rodrick Rules,73695194,52698535,20996659,18233280,18000000
The Jerk,73691419,73691419,00000,,00000
Life,73475268,64016268,9459000,,75000000
Next,73430355,18049868,55380487,19154984,00000
Beetle Juice,73326666,73326666,00000,,15000000
Here Comes the Boom,73239258,45290318,27948940,14420019,42000000
"Dude, Where's My Car?",73180297,46729374,26450923,,13000000
Eternal Sunshine of the Spotless Mind,73135439,34366518,38768921,,20000000
Tong zhuo de ni,73050000,00000,73050000,,00000
Superhero Movie,73026302,26638520,46387782,12475089,35000000
Ben-Hur,73000000,73000000,00000,,15000000
Hana yori dango: Fainaru,73000000,00000,73000000,,00000
The Best Man Holiday,72835710,70525195,2310515,14371353,17000000
Lady in the Water,72785169,42285169,30500000,12529986,75000000
Urban Legend,72503794,38048637,34455157,,14000000
"Yours, Mine and Ours",72359917,53359917,19000000,27241398,45000000
Death Race,72298317,36097530,36200787,27641770,65000000
Fack ju Gothe,72296417,00000,72296417,,00000
Colombiana,72295262,36665854,35629408,10195726,40000000
Problem Child,72270895,53470891,18800004,,00000
La famille Bélier,72227366,00000,72227366,,00000
Always,72143630,41843630,30300000,,00000
Wan P_su Firumu: Zetto,72028342,00000,72028342,,00000
Around the World in 80 Days,72004159,24004159,48000000,,110000000
My Fair Lady,72000000,72000000,00000,,17000000
Funny People,71880305,51855045,20025260,15143649,72500000
The Last of the Mohicans,71759298,71759298,00000,,40000000
Rules of Engagement,71719931,61322858,10397073,,60000000
Thermae Romae,71671405,00000,71671405,,00000
Sammy's avonturen: De geheime doorgang,71594792,00000,71594792,,25000000
Trainspotting,71560987,16501000,55059987,,3100000
Bandits,71523271,41523271,30000000,,75000000
Grumpier Old Men,71499832,71499832,00000,,00000
The Royal Tenenbaums,71430876,52353636,19077240,,28000000
The House Bunny,71390601,48237389,23153212,16529196,25000000
What Dreams May Come,71350897,55350897,16000000,,80000000
3 Men and a Little Lady,71338379,71338379,00000,,00000
War Room,71320206,67674672,3645534,,00000
National Lampoon's Christmas Vacation,71319546,71319546,00000,,00000
Holes,71232214,67383924,3848290,,20000000
Shanghai Noon,71189835,56932305,14257530,,55000000
Down to Earth,71172251,64172251,7000000,,30000000
3:10 to Yuma,71171825,53606916,17564909,56579912,48000000
Small Soldiers,71052676,54452676,16600000,,40000000
The Counselor,71009334,16973715,54035619,4121801,25000000
Anna Karenina,71004627,12816367,58188260,4341025,49000000
Cleopatra,71000000,57000000,14000000,2669259,42000000
The Naked Gun: From the Files of Police Squad!,70956485,70956485,00000,,00000
Son of God,70949793,59700064,11249729,8922028,22000000
Kate and Leopold,70937778,47095453,23842325,,48000000
Shallow Hal,70836296,70836296,00000,,40000000
The Cabin in the Woods,70768144,42073277,28694867,7830720,30000000
Curious George,70749050,58336565,12412485,48239767,50000000
The Grudge 2,70743839,39143839,31600000,14655066,20000000
Hannah Montana/Miley Cyrus: Best of Both Worlds Concert Tour,70712099,65281781,5430318,23610673,6500000
Ronin,70690810,41609593,29081217,,55000000
Any Which Way You Can,70687344,70687344,00000,,00000
Takers,70587268,57744720,12842548,18545415,32000000
The Dilemma,70546865,48475290,22071575,7060683,70000000
Odoru Daisôsasen the Final: Aratanaru kibô,70519044,00000,70519044,,00000
Stop! Or My Mom Will Shoot,70411000,28411000,42000000,,00000
The Hills Have Eyes,70355813,41778863,28576950,27046152,17000000
Anacondas: The Hunt for the Blood Orchid,70326393,31526393,38800000,,25000000
XXX: State of the Union,70282914,26082914,44200000,,60000000
Babylon A.D.,70216497,22532572,47683925,25483172,45000000
License to Wed,70187088,43799818,26387270,22930953,35000000
Grumpy Old Men,70172621,70172621,00000,,00000
The Last Exorcism,70165900,41034350,29131550,6979413,1800000
A Cinderella Story,70164105,51438175,18725930,,19000000
Turner & Hooch,70131974,70131974,00000,,00000
House of Wax,70064800,32064800,38000000,,35000000
Think Like a Man Too,70027933,65028687,4999246,3055664,24000000
The Pink Panther 2,70022978,35922978,34100000,7870575,00000
Halloween,70000000,47000000,23000000,,325000
Lawrence of Arabia,69995385,37495385,32500000,,15000000
Private Benjamin,69847348,69847348,00000,,15000000
Tae Guik Gi: The Brotherhood of War,69826708,1110186,68716522,,12500000
Grudge Match,69807260,29807260,40000000,2683126,40000000
The Brave One,69792704,36793804,32998900,17836254,00000
A Very Long Engagement,69759296,6167817,63591479,,55000000
Saw VI,69752402,27693292,42059110,10626513,11000000
The Best Little Whorehouse in Texas,69701637,69701637,00000,,20500000
The Kid,69688384,69688384,00000,,65000000
Hero,69671205,00000,69671205,,00000
Children of Men,69628780,35327768,34301012,25487173,76000000
Dolphins,69600000,54000000,15600000,,00000
Land of the Lost,69548641,49438370,20110271,23071093,100000000
Because I Said So,69538833,42674040,26864793,24052104,39000000
3 Idiots,69533849,6533849,63000000,,00000
The Adventures of Sharkboy and Lavagirl in 3-D,69425823,39177541,30248282,,50000000
Bad Company,69157016,30157016,39000000,,70000000
Babe: Pig in the City,69130000,18318000,50812000,,80000000
John Tucker Must Die,68824526,41011711,27812815,32808182,00000
Benpao Ba! Xiongdi,68779297,309297,68470000,,00000
Precious (Based on the Novel Push by Sapphire),68722848,47566524,21156324,24353415,10000000
From Hell,68712365,31598308,37114057,,35000000
2001: A Space Odyssey,68700000,56700000,12000000,,10500000
Star Wars: The Clone Wars,68695443,35161554,33533889,27108311,8500000
Open Range,68613992,58331254,10282738,,26000000
The Call,68553522,51872378,16681144,10583904,12800000
One Direction: This is Us,68541786,28873374,39668412,13445942,10000000
Star Trek V: The Final Frontier,68521916,50531965,17989951,,30000000
Ruthless People,68508328,68508328,00000,,00000
Groundhog Day,68504696,68504696,00000,,14600000
Thirteen Ghosts,68467960,41867960,26600000,,19000000
Pokemon 3: The Movie,68452128,17052128,51400000,,3000000
Purple Rain,68392977,68392977,00000,,00000
Ghost Ship,68349884,30113491,38236393,,20000000
Stalingrad,68245261,1013945,67231316,270327,00000
Mr. Magorium's Wonder Emporium,68191643,32061555,36130088,24811942,00000
The X-Files: I Want to Believe,68170792,20982478,47188314,16329675,35000000
Taxi,68109966,36609966,31500000,,00000
Practical Magic,68097643,46611204,21486439,,60000000
Frequency,68079671,44983704,23095967,,31000000
Gedo Senki (Tales from Earthsea),68048658,48658,68000000,,00000
The American,67950723,35606376,32344347,8149174,20000000
Letters from Iwo Jima,67867998,13756082,54111916,13643821,13000000
Todo sobre mi madre,67864530,8264530,59600000,,00000
Austin Powers: International Man of Mystery,67668030,53868030,13800000,,18000000
Sudden Impact,67642693,67642693,00000,,00000
Legion,67602432,40122938,27479494,19041756,26000000
Outbreak,67598303,67598303,00000,,50000000
The Little Prince,67596879,00000,67596879,,77500000
A Perfect Murder,67549705,67549705,00000,,00000
Moonrise Kingdom,67503425,45512466,21990959,10172374,16000000
Prime,67428025,22728025,44700000,10342922,00000
The Watch,67353000,34353000,33000000,6260291,55000000
The Men Who Stare at Goats,67348218,32428195,34920023,9933223,24000000
Runaway Jury,67338219,49440996,17897223,,00000
Broadcast News,67331309,51249404,16081905,,00000
Chennai Express,67283612,5307960,61975652,,00000
The Next Three Days,67255916,21148651,46107265,9818780,30000000
Sole A Catinelle,67239180,00000,67239180,,00000
When a Stranger Calls,67215435,47860214,19355221,13276661,15000000
Coal Miner's Daughter,67182787,67182787,00000,,15000000
Star Trek: Nemesis,67178296,43119879,24058417,,60000000
Secret of the Wings,67084376,00000,67084376,47419465,00000
Space Chimps,67029956,30105968,36923988,14481370,37000000
The Secret of My Success,66995000,66995000,00000,,00000
Run All Night,66961644,26461644,40500000,4483667,50000000
102 Dalmatians,66941559,66941559,00000,,85000000
Boogeyman,66803595,46363118,20440477,,20000000
Hubble 3D,66794251,50626351,16167900,,00000
Changing Lanes,66790248,66790248,00000,,45000000
Selma,66776908,52076908,14700000,4608274,20000000
Our Times,66657351,00000,66657351,,00000
The Transporter Refueled,66653404,16029670,50623734,,22000000
Huo Yuan Jia,66633730,24633730,42000000,31373806,00000
Thirteen Days,66554547,34566746,31987801,,80000000
Honig im Kipf,66521876,00000,66521876,,00000
The Godfather: Part III,66520529,66520529,00000,,54000000
The Little Rascals,66402015,51219015,15183000,,00000
Okuribito,66143346,1543346,64600000,,00000
The Bank Job,66143005,30060660,36082345,18336272,20000000
Smokey and the Bandit II,66132626,66132626,00000,,00000
Antarctica,66070389,65000000,1070389,,00000
August Rush,66015869,31664162,34351707,26663771,25000000
Fei Cheng Wu Rao 2,66009013,182517,65826496,,00000
Hot Tub Time Machine,65967750,50269859,15697891,25681381,36000000
Barbershop 2: Back in Business,65842412,65070412,772000,,18000000
K-19: The Widowmaker,65716126,35168966,30547160,,90000000
Bei Jing Ai Qing Gu Shi,65713598,423598,65290000,,00000
Ever After: A Cinderella Story,65703412,65703412,00000,,26000000
The Road to El Dorado,65700000,50802661,14897339,,95000000
Se jie,65696051,4604982,61091069,,15000000
Dan in Real Life,65669001,47642963,18026038,20894036,00000
Tyler Perry's Madea's Witness Protection,65653242,65653242,00000,12399900,20000000
Sweet November,65644290,25178165,40466125,,40000000
16 Blocks,65583539,36883539,28700000,20147983,45000000
Witness,65532576,65532576,00000,,12000000
The Ghost Writer,65532491,15541549,49990942,4692304,45000000
Dao shi xia shan,65522293,00000,65522293,,00000
Hero,65507017,18207017,47300000,,42000000
Street Kings,65454793,26415649,39039144,13883545,20000000
Born on the Fourth of July,65441414,65441414,00000,,14000000
Killer Elite,65409046,25124986,40284060,7212430,70000000
Take the Lead,65390493,34742066,30648427,21195641,30000000
Hanna,65343694,40259119,25084575,6339651,30000000
Donnie Brasco,65303052,41954997,23348055,,35000000
Jersey Boys,65282732,47047013,18235719,7815144,40000000
The Hard Way,65228035,24228035,41000000,,00000
Jing Cheng 81 Hao,65220000,00000,65220000,,00000
"Fort Apache, The Bronx",65200000,29200000,36000000,,00000
Without a Paddle,65121280,58156435,6964845,,30000000
House on Haunted Hill,65090541,40846082,24244459,,19000000
Something Borrowed,65084116,39046489,26037627,10006242,35000000
Underdog,65033328,43760605,21272723,38749931,00000
Ferris Bueller's Day Off,65008271,65008271,00000,,00000
Song of the South,65000000,65000000,00000,,00000
The Living Sea,64800000,64800000,00000,,00000
Mr. Mom,64736362,64736362,00000,,00000
Haeundae,64733391,00000,64733391,,00000
Nothing To Lose,64591257,44477235,20114022,,25000000
The Host,64477051,26623701,37853350,6520268,50000000
Miracle,64474705,64378093,96612,,28000000
The Imaginarium of Doctor Parnassus,64352607,7689607,56663000,7558720,30000000
The Jewel of the Nile,64323063,64323063,00000,,00000
Tropa de Elite 2: O Inimigo Agora É Outro,64307758,100119,64207639,,00000
Monster,64240813,34469210,29771603,,5000000
Taking Lives,64232363,32682342,31550021,,00000
28 Weeks Later,64231305,28637507,35593798,24681478,15000000
Wag the Dog,64217092,43022524,21194568,,15000000
Uncle Buck,64189596,64189596,00000,,00000
Valiant,64188387,19478106,44710281,,35000000
Eien No 0,64071217,00000,64071217,,00000
Zhong Kui fu mo: Xue yao mo ling,64036296,165428,63870868,16244,00000
Baby Mama,63998025,60321790,3676235,31916351,30000000
The Remains of the Day,63954968,22954968,41000000,,15000000
Scent of a Woman,63895607,63895607,00000,,00000
High Crimes,63781100,41543207,22237893,,42000000
God’s Not Dead,63777092,60755732,3021360,21103430,1150000
What About Bob?,63710000,63710000,00000,,00000
Flags of Our Fathers,63657941,33602376,30055565,45136320,53000000
Cop Land,63610734,44810734,18800000,,15000000
Risky Business,63541777,63541777,00000,,00000
Stuck On You,63537164,33832741,29704423,,55000000
A Fish Called Wanda,63493000,63493000,00000,,00000
In Good Company,63489752,45489752,18000000,,26000000
Conan the Barbarian,63356133,21295021,42061112,10595678,90000000
Madea's Family Reunion,63320521,63257940,62581,29456049,10000000
She's All That,63319509,63319509,00000,,10000000
Devil,63275649,33601190,29674459,7936200,10000000
Lions for Lambs,63211088,14998070,48213018,12721245,35000000
Random Hearts,63200000,31054924,32145076,,64000000
Stakeout,63139023,63139023,00000,,00000
Kick-Ass 2,63129909,28795985,34333924,9060022,28000000
A Star is Born,63129898,63129898,00000,,00000
Rising Sun,63095271,63095271,00000,,00000
The Sweetest Thing,63078756,24430272,38648484,,43000000
Beavis and Butt-head Do America,63071133,63071133,00000,,12000000
Jiàngúo dàyè,62995096,00000,62995096,,00000
Footloose,62989834,51802742,11187092,14392573,24000000
The Peacemaker,62960505,41256277,21704228,,50000000
Pirates,62883705,160133,62723572,19372,00000
The Benchwarmers,62871766,57651794,5219972,32934894,35000000
Piglet's Big Movie,62870546,23103423,39767123,,00000
The Darkest Hour,62831715,21443494,41388221,5292804,34800000
The Witches of Eastwick,62787608,62787608,00000,,00000
Proof of Life,62761005,32598931,30162074,,65000000
Honey,62646763,30272254,32374509,,18000000
Runner Runner,62616646,19316646,43300000,3654635,30000000
Splash,62599495,62599495,00000,,8000000
Unfriended,62561449,32482090,30079359,2310907,1000000
Perfect Stranger,62526388,23760822,38765566,23840186,00000
Patton,62500000,62500000,00000,,12000000
Gwansang,62490342,484112,62006230,,00000
Snow Day,62452927,60008303,2444624,,13000000
Like Mike,62432423,51432423,11000000,,30000000
Not Another Teen Movie,62401343,37882551,24518792,,15000000
Ek Tha Tiger,62347774,2347774,60000000,,00000
Bai tuan da zhan,62340000,00000,62340000,,00000
Flickan som lekte med elden,62287423,9081782,53205641,5928431,00000
The Reaping,62226214,25126214,37100000,20075032,40000000
Ninja Assassin,62209892,38122883,24087009,16454590,50000000
Captain Corelli's Mandolin,62097495,25528495,36569000,,57000000
28 Days,62063972,37035515,25028457,,43000000
Snakes on a Plane,62020814,34020814,28000000,31319738,33000000
Keinohrhasen,62000000,00000,62000000,,00000
An American Werewolf in London,61973249,31973249,30000000,,00000
Two Brothers,61947630,18947630,43000000,,72000000
I Love Trouble,61947267,30806194,31141073,,00000
Friday Night Lights,61882934,61188085,694849,,30000000
The White Haired Witch of Lunar Kingdom,61850000,00000,61850000,,00000
Mouse Hunt,61834214,61834214,00000,,38000000
Tango & Cash,61772769,61772769,00000,,55000000
The Tree of Life,61721826,13305665,48416161,,35000000
The 13th Warrior,61694788,32694788,29000000,,125000000
Working Girl,61669658,61669658,00000,,00000
Umizaru 2: Test of Trust,61600000,00000,61600000,,00000
The Crying Game,61587055,61587055,00000,,4000000
Begin Again,61584027,16170632,45413395,4563206,8000000
A History of Violence,61477797,31493782,29984015,38699127,32000000
Cellular,61475984,32003620,29472364,,45000000
Larry Crowne,61449135,35608245,25840890,6188163,30000000
The Legend of Hercules,61402445,18848538,42553907,8045946,70000000
National Lampoon's Summer Vacation,61399552,61399552,00000,,00000
The Goonies,61389680,61389680,00000,,00000
Flatliners,61308153,61308153,00000,,26000000
The Longest Ride,61146117,37446117,23700000,14605879,34000000
Misery,60889526,60889526,00000,,00000
Taxi 4,60865364,00000,60865364,,00000
Marie Antoinette,60862471,15962471,44900000,16699054,40000000
Why Did I Get Married Too?,60831067,60095852,735215,20714347,20000000
Zoolander,60780981,45172250,15608731,,28000000
My Super Ex-Girlfriend,60772856,22530295,38242561,,30000000
Astérix et Obélix: Au service de Sa Majesté ,60680125,00000,60680125,,77600000
Fantasia 2000 (IMAX),60507228,60507228,00000,,80000000
Kiss the Girls,60491560,60491560,00000,,27000000
The Wild Thornberrys Movie,60468965,39882925,20586040,,25000000
Lord of War,60437727,24149632,36288095,,42000000
Ten Things I Hate About You,60414025,38177966,22236059,,13000000
Secretariat,60376247,59699513,676734,42028421,35000000
The Age of Adaline,60333540,42629776,17703764,3907141,30000000
Side Effects,60288363,32172757,28115606,2582771,30000000
Beautiful Creatures,60282876,19452138,40830738,6933883,50000000
I Spy,60279822,33561137,26718685,,70000000
The Insider,60265197,28965197,31300000,,68000000
Jiàn D_ng W_i Yè,60248011,151305,60096706,,00000
127 Hours,60217171,18335230,41881941,10602721,18000000
Les Rivières Pourpres,60132548,632548,59500000,,00000
Field of Dreams,60045168,60045168,00000,,00000
It's a Mad Mad Mad Mad World,60000000,46300000,13700000,,9400000
Spartacus,60000000,30000000,30000000,,12000000
Superman III,59950623,59950623,00000,,39000000
Jungle 2 Jungle,59925026,59925026,00000,,00000
A Haunted House,59922558,40041683,19880875,6173013,2500000
Son of the Mask,59918422,17018422,42900000,,100000000
Morning Glory,59795070,31011732,28783338,8740386,40000000
Friday the 13th,59754601,39754601,20000000,,550000
The Perfect Guy,59707073,57017904,2689169,,00000
Next Friday,59675307,57176582,2498725,,9500000
Down and Out in Beverly Hills,59670792,59670792,00000,,00000
21 Grams,59667625,16248701,43418924,,20000000
Dr. No,59567035,16067035,43500000,,1000000
Aliens in the Attic,59551283,25200412,34350871,13696617,45000000
Chain Reaction,59533842,20550712,38983130,,55000000
Spies Like Us,59526202,59526202,00000,,00000
The Last Boy Scout,59509925,59509925,00000,,00000
Scrooged,59450353,59450353,00000,,32000000
The Flintstones in Viva Rock Vegas,59431365,35231365,24200000,,58000000
Good Luck Chuck,59183821,35017297,24166524,26509944,25000000
One Day,59168692,13843771,45324921,,15000000
Matchstick Men,59165300,36873198,22292102,,00000
(500) Days of Summer,59101642,32391374,26710268,18553712,7500000
Chong fan 20 sui,59010000,00000,59010000,,00000
The Gift,58978653,43787265,15191388,519318,5000000
Jeepers Creepers,58939035,37904175,21034860,,10000000
Must Love Dogs,58894863,43894863,15000000,,35000000
Far and Away,58883840,58883840,00000,,00000
Behind Enemy Lines,58855732,58855732,00000,,40000000
Sliding Doors,58781444,11883495,46897949,,6000000
Honey I Blew Up the Kid,58662452,58662452,00000,,00000
Jack,58617334,58617334,00000,,45000000
Zathura,58545540,28045540,30500000,22146859,65000000
Invincible,58501127,57806952,694175,48216225,40000000
Funny Girl,58500000,58500000,00000,,00000
Doragon bôru Z: Fukkatsu no 'F',58408363,8008363,50400000,3228019,00000
The Ninth Gate,58394308,18653746,39740562,,38000000
Are We Done Yet?,58357493,49631958,8725535,23223387,00000
Dave,58340177,58340177,00000,,00000
Little Nicky,58270391,39442871,18827520,,80000000
Bowling for Columbine,58240487,21576018,36664469,,3000000
Agent Cody Banks,58240458,47545060,10695398,,25000000
Dragonball Evolution,58228460,9362785,48865675,6448799,30000000
Amistad,58212953,44175394,14037559,,40000000
That's My Boy,58058367,36931089,21127278,5739070,57500000
Inkheart,58051454,17303424,40748030,9075540,60000000
My Girl,58011485,58011485,00000,,16500000
The Inbetweeners 2,58000000,00000,58000000,,00000
Yi dai zong shi,57987299,6594959,51392340,831213,38600000
Snitch,57907734,42930462,14977272,10539054,15000000
Dolphin Tale 2,57824533,42024533,15800000,13514872,36000000
U.S. Marshals,57823170,57823170,00000,,00000
Heartbreakers,57753825,40334024,17419801,,38000000
Year One,57604723,43337279,14267444,17250109,60000000
The Eye,57577765,31418697,26159068,16611478,12000000
Derailed,57520063,36020063,21500000,27881446,22000000
The Cannonball Run,57498710,57498710,00000,,00000
Under the Tuscan Sun,57490024,43601508,13888516,,18000000
The Specialist,57344996,57344996,00000,,45000000
Sister Act 2 Back in the Habit,57319029,57319029,00000,,00000
The Godfather: Part II,57300000,57300000,00000,,13000000
Milk,57293371,31841299,25452072,11338216,20000000
Willow,57269863,57269863,00000,,00000
Smokin' Aces,57263440,35662731,21600709,35912967,17000000
The Blues Brothers,57229890,57229890,00000,,27000000
Prom Night,57193655,43869350,13324305,11722579,18000000
The Mist,57189408,25593755,31595653,29502163,13000000
"What's Up, Doc?",57142740,57142740,00000,,00000
Annie,57059003,57059003,00000,,00000
The Descent,57051053,26024456,31026597,22628639,7000000
Evangelion Shin Gekijôban: Kyu,57019825,00000,57019825,,00000
Crossroads,57000000,37188667,19811333,,12000000
Beethoven,56979478,56979478,00000,,00000
The Man in the Iron Mask,56876365,56876365,00000,,35000000
Into the Wild,56822960,18354356,38468604,21463396,20000000
A Civil Action,56702901,56702901,00000,,60000000
Guess Who's Coming to Dinner,56700000,56700000,00000,,00000
The Final Countdown,56647800,16647800,40000000,,00000
Murder by Numbers,56643267,31874869,24768398,,50000000
You Are My Sunshine,56620000,00000,56620000,,00000
Clueless,56598476,56598476,00000,,13700000
"Good Night, and Good Luck",56586901,31501218,25085683,20982727,7000000
Remember Me,56506120,19068240,37437880,14003790,16000000
Tombstone,56505065,56505065,00000,,25000000
The Crazies,56445534,39123589,17321945,11181285,19000000
The Mothman Prophecies,56438555,35228696,21209859,,42000000
Cradle 2 the Grave,56434942,34657731,21777211,,25000000
Elektra,56409722,24409722,32000000,,65000000
Drumline,56398162,56398162,00000,,20000000
15 Minutes,56331864,24375436,31956428,,42000000
Dragnet,56287154,56287154,00000,,00000
Dallas Buyers Club,56238045,27298285,28939760,5798457,5000000
Boyz n the Hood,56190094,56190094,00000,,6500000
Quartet,56178935,18388357,37790578,2366456,11000000
Frida,56131239,25885000,30246239,,12000000
The Big Chill,56077501,56077501,00000,,00000
Eastern Promises,56077088,17181265,38895823,15942559,50000000
Silent Hill: Revelation 3D,55975672,17530219,38445453,4245909,20000000
Spice World,55947405,29247405,26700000,,25000000
Why Did I Get Married?,55934178,55204525,729653,33820538,15000000
Cop Out,55909910,44875481,11034429,14120949,37000000
Woman in Gold,55766926,33307793,22459133,2636572,11000000
End of Watch,55763960,41003371,14760589,16101772,15000000
The Animal,55762229,55762229,00000,,22000000
In Search of Noah's Ark,55700000,55700000,00000,,00000
Pay it Forward,55696705,33508922,22187783,,40000000
The Aristocats,55675257,55675257,00000,,00000
The Craft,55603049,24703049,30900000,,15000000
The Beverly Hillbillies,55598481,42222647,13375834,,00000
Kicking and Screaming,55580895,52580895,3000000,,45000000
Wild Things,55535344,29753944,25781400,,20000000
Open Water,55518641,30500882,25017759,,500000
Lucky Number Slevin,55495466,22495466,33000000,27011926,27000000
Out of Time,55489826,41083108,14406718,,50000000
Never Been Kissed,55474757,55474757,00000,,00000
The Lizzie McGuire Movie,55472630,42672630,12800000,,15000000
Rugrats Go Wild,55443032,39402572,16040460,,25000000
Great Expectations,55406438,26333044,29073394,,00000
"Definitely, Maybe",55350057,31973840,23376217,13440056,7000000
Police Academy 2: Their First Assignment,55337042,55337042,00000,,00000
We Own the Night,55307857,28563179,26744678,22679711,28000000
Yi jiu si er,55287687,212475,55075212,,00000
Extremely Loud and Incredibly Close,55247881,31847881,23400000,9750256,40000000
Chariots of Fire,55222653,55222653,00000,,5500000
Waking Ned Devine,55188807,24788807,30400000,,3000000
The Giver,55090374,45090374,10000000,6335096,25000000
She's the Man,55078079,33687630,21390449,33648752,25000000
The Motorcycle Diaries,55029200,16756372,38272828,,00000
Halloween: H2O,55004135,55004135,00000,,17000000
Dawn of the Dead,55000000,5100000,49900000,,1500000
Analyze That,54994757,32122249,22872508,,60000000
Beaches,54849107,54849107,00000,,00000
St. Vincent,54837234,44137712,10699522,5313995,13000000
Predator 2,54768418,28317513,26450905,,35000000
The Five-Year Engagement,54732938,28700285,26032653,5119248,30000000
Ironiya Sudby.  Prodolzhenie,54700664,00000,54700664,,00000
Shi Lian 33 Tian,54640000,00000,54640000,,00000
The Hot Chick,54639509,35081550,19557959,,00000
Qin ai de,54630000,00000,54630000,,00000
Driven,54616869,32616869,22000000,,72000000
National Security,54599300,36288951,18310349,,00000
Looney Tunes: Back in Action,54540662,20950820,33589842,,80000000
The Punisher,54440783,33571379,20869404,,33000000
Doom,54431250,28031250,26400000,28689950,70000000
Spanglish,54344321,42044321,12300000,,75000000
No Good Deed,54323210,52543632,1779578,6207136,13200000
Varsity Blues,54294169,52894169,1400000,,16000000
Domestic Disturbance,54207112,45207112,9000000,,53000000
The Verdict,53977250,53977250,00000,,16000000
Edward Scissorhands,53976987,53976987,00000,,20000000
Mickey Blue Eyes,53864342,33864342,20000000,,40000000
The International,53850527,25450527,28400000,8125417,50000000
The Three Stooges,53801644,44338224,9463420,20668040,30000000
The Borrowers,53785536,22359293,31426243,,29000000
The Messengers,53774833,35374833,18400000,16269253,16000000
Doc Hollywood,53732464,53732464,00000,,00000
Rookie of the Year,53579269,53579269,00000,,00000
Stranger Than Fiction,53572822,40435190,13137632,31104418,30000000
Nine,53508858,19676965,33831893,5480837,80000000
Bounce,53425292,36805288,16620004,,35000000
Throw Momma From the Train,53380796,53380796,00000,,00000
Sea of Love,53350495,53350495,00000,,19000000
Madea's Big Happy Family,53345287,53345287,00000,11202686,00000
Radio,53293628,52333738,959890,,35000000
Papillon,53267000,53267000,00000,,00000
Hollywood Adventures,53246837,00000,53246837,,00000
Arachnophobia,53208180,53208180,00000,,31000000
Doubt,53191101,33446470,19744631,14119802,20000000
Pitch Black,53182088,39235088,13947000,,23000000
From Paris With Love,53139168,24077427,29061741,15841359,52000000
That Awkward Moment,53068955,26068955,27000000,2959716,8000000
Wickie und die starken Männer,53049987,00000,53049987,,00000
Konferenz der Tiere,53048539,00000,53048539,,30000000
To the Limit,53000000,53000000,00000,,00000
Suspect X,53000000,00000,53000000,,00000
The Sinking of Japan,53000000,00000,53000000,,00000
My Cousin Vinny,52929168,52929168,00000,,11000000
Outrageous Fortune,52864741,52864741,00000,,00000
Pooh's Heffalump Movie,52858433,18098433,34760000,,20000000
Message in a Bottle,52799004,52799004,00000,,30000000
Pet Sematary,52795778,52795778,00000,,11500000
The Recruit,52784696,52784696,00000,,00000
Choi-jong-byeong-gi-hwal,52760691,40685,52720006,,00000
American Gigolo,52743674,22743674,30000000,,00000
The Odd Life of Timothy Green,52685425,51853450,831975,15710732,40000000
La Bamba,52678820,52678820,00000,,6500000
Sinister 2,52650204,27740955,24909249,,10000000
Untraceable,52649951,28687835,23962116,20862732,35000000
Beethoven's 2nd,52636940,52636940,00000,,00000
The Roommate,52545707,37300107,15245600,5469222,16000000
Tyler Perry's A Madea Christmas,52543354,52543354,00000,12348199,25000000
Wild,52501541,37880356,14621185,5273435,15000000
Big Fat Liar,52461017,47811275,4649742,,15000000
An Inconvenient Truth,52438751,23814997,28623754,31629455,1000000
The Boy Next Door,52426530,35423380,17003150,4750097,4000000
Unlawful Entry,52404352,52404352,00000,,00000
Le Petit Nicolas,52339566,201857,52137709,,30000000
Ordinary People,52302978,52302978,00000,,6000000
Stand by Me,52287414,52287414,00000,,8000000
One Hour Photo,52223306,31597131,20626175,,12000000
00010,52134699,52134699,00000,,00000
"South Park: Bigger, Longer & Uncut",52037603,52037603,00000,,21000000
Tyler Perry's Temptation,51975354,51975354,00000,12532275,00000
Lawless,51932335,37397291,14535044,16363936,26000000
Hanging Up,51867723,36037909,15829814,,40000000
I Can Do Bad All By Myself,51733921,51733921,00000,19657313,19000000
Maximum Risk,51639438,14039438,37600000,,25000000
Blue Crush,51618420,40118420,11500000,,30000000
Amadeus,51564280,51564280,00000,,18000000
Daybreakers,51445503,30101577,21343926,13796622,20000000
Mortal Kombat: Annihilation,51327406,35927406,15400000,,30000000
RoboCop,51327050,51327050,00000,,13000000
Awakenings,51306865,51306865,00000,,00000
Hooper,51290536,51290536,00000,,00000
Fargo,51184363,24547547,26636816,,7000000
Bodyguard,51119758,1834384,49285374,,00000
Hollywood Homicide,51107785,30207785,20900000,,75000000
Silver Streak,51079064,51079064,00000,,00000
The Family,51078541,36918811,14159730,9466286,30000000
"Oh, God!",51061196,51061196,00000,,00000
All the President's Men,51048435,51048435,00000,,00000
Las aventuras de Tadeo Jones,51031724,00000,51031724,64752,00000
The Spy Next Door,50983364,24307106,26676258,9152849,28000000
Enough,50970660,39177215,11793445,,38000000
Bull Durham,50888729,50888729,00000,,00000
College Road Trip,50873923,45610425,5263498,19223670,00000
Yeh Jawaani Hai Deewani,50827466,3827466,47000000,,8300000
Naked Gun 33 1/3: The Final Insult,50825302,50825302,00000,,30000000
Coco avant Chanel,50813834,6113834,44700000,,23000000
You Got Served,50811858,40066497,10745361,,8000000
A Bridge Too Far,50800000,50800000,00000,,26000000
Gekijouban Pokketo monsutâ Besuto wisshu: Pikutini to kuroku eiyuu Zekuromu,50776443,00000,50776443,,00000
Feng Bao,50770000,00000,50770000,,00000
Hable con ella,50768280,9284265,41484015,,00000
August:  Osage County,50738810,37738810,13000000,7461193,25000000
Sea Monsters: A Prehistoric Adventure,50728163,23746066,26982097,,00000
Elizabethtown,50719373,26850426,23868947,15902214,54000000
Bonnie and Clyde,50700000,50700000,00000,,00000
Boyhood,50689197,25379975,25309222,3350686,4000000
The Deep,50681884,50681884,00000,,00000
Bride of Chucky,50656960,32368960,18288000,,25000000
Meet Dave,50648806,11803254,38845552,,60000000
The Crow,50638075,50638075,00000,,00000
Mighty Joe Young,50628009,50628009,00000,,80000000
Notes on a Scandal,50578411,17510118,33068293,8984051,27500000
The Love Bug,50576808,50576808,00000,,00000
Nowhere to Run,50570994,20570994,30000000,,15000000
Sneakers,50560948,50560948,00000,,00000
The Texas Chainsaw Massacre: The Beginning,50517763,39517763,11000000,29530651,16000000
Eddie Murphy Raw,50504655,50504655,00000,,00000
Diary of a Mad Black Woman,50458356,50406346,52010,,5500000
About Last Night,50445860,48637684,1808176,4792929,13000000
The Nightmare Before Christmas,50408318,50408318,00000,,00000
The Three Musketeers,50375628,50375628,00000,,00000
Red Tails,50365498,49876377,489121,16265594,58000000
K-PAX,50315140,50315140,00000,,48000000
Team America: World Police,50274834,32774834,17500000,,20000000
Brick Mansions,50236829,20396829,29840000,3433425,28000000
Natural Born Killers,50215954,50215954,00000,,00000
Grindhouse,50187789,25031037,25156752,36798570,53000000
Supercondriaque,50160446,00000,50160446,,00000
The Color of Money,50159778,50159778,00000,,10000000
Winnie the Pooh,50145607,26692846,23452761,14420443,30000000
Breakdown,50129186,50129186,00000,,36000000
Rock of Ages,50118613,38518613,11600000,11820431,70000000
The Women,50103808,26902075,23201733,12739479,16000000
The Longest Day,50100000,39100000,11000000,,10000000
Sphere,50076367,36976367,13100000,,73000000
Fever Pitch,50071069,42071069,8000000,,40000000
The Replacements,50054511,44737059,5317452,,50000000
Absolute Power,50007168,50007168,00000,,50000000
Little Women,50003303,50003303,00000,,15000000
Reds,50000000,50000000,00000,,33500000
The Deer Hunter,50000000,50000000,00000,,15000000
He Yi Sheng Xiao Mo,50000000,00000,50000000,,00000
A Walk in the Clouds,49993080,49993080,00000,,00000
Capote,49924079,28750530,21173549,17037721,7000000
The Way We Were,49919870,49919870,00000,,00000
The Hurt Locker,49894223,17017811,32876412,38821563,15000000
The Switch,49858465,27758465,22100000,9013736,19000000
Popeye,49823037,49823037,00000,,20000000
Major League,49793054,49793054,00000,,11000000
Pleasantville,49789066,40568025,9221041,,00000
The Mighty Ducks,49764659,49764659,00000,,10000000
"Planes, Trains & Automobiles",49752241,49509935,242306,,00000
Kokuriko-zaka Kara,49743812,1000878,48742934,2364489,00000
Leaving Las Vegas,49737350,31921127,17816223,,4000000
Angels in the Outfield,49735551,49735551,00000,,00000
This Christmas,49733545,49121934,611611,23932460,13000000
Sky Captain and the World of Tomorrow,49730854,37760080,11970774,,70000000
Ip Man: Legend of the Grand Master,49721954,205675,49516279,2701486,00000
The Abyss,49710458,49710458,00000,,70000000
Drillbit Taylor,49686263,32862104,16824159,14878580,40000000
How Do You Know?,49628177,30212620,19415557,10064612,120000000
The Ant Bully,49610898,28142535,21468363,35995549,45000000
The Fourth Kind,49486874,26218170,23268704,9127616,10000000
Dark Water,49473093,25473093,24000000,,60000000
Jonas Brothers: The 3D Concert Experience,49440776,38174685,11266091,9067173,00000
Oliver & Company,49424284,49424284,00000,,00000
Shampoo,49407734,49407734,00000,,00000
A Nightmare on Elm Street 4: The Dream Master,49369899,49369899,00000,,13000000
National Lampoon's European Vacation,49364621,49364621,00000,,00000
Biloxi Blues,49181353,40681353,8500000,,00000
The Last King of Scotland,49155371,17606684,31548687,18299195,6000000
42142,49136551,00000,49136551,,00000
The Black Dahlia,49110792,22545080,26565712,12386807,60000000
Bugsy,49103967,49103967,00000,,00000
Danny the Dog,49037621,24537621,24500000,,43000000
Arthur et la vengeance de Maltazard,48995492,347136,48648356,,00000
Death at a Funeral,48977233,42739347,6237886,13952141,21000000
Alpha and Omega 3D,48958353,25107267,23851086,11348417,20000000
The Negotiator,48884065,44484065,4400000,,50000000
Her,48783090,25568251,23214839,2945072,23000000
The Rescuers,48775599,48775599,00000,,00000
Creed,48668257,46368257,2300000,,37000000
When a Man Loves a Woman,48586043,48586043,00000,,00000
The Avengers,48585416,23385416,25200000,,60000000
The Omen,48570885,48570885,00000,,2800000
Fat Albert,48563556,48114556,449000,,45000000
00009,48559999,31749894,16810105,11280652,30000000
Parker,48543388,17616641,30926747,7998673,35000000
Frozen,48533065,246177,48286888,3362513,00000
Les petits mouchoirs,48530887,205505,48325382,,25000000
Magnolia,48446802,22450975,25995827,,37000000
Charlie St. Cloud,48434366,31162545,17271821,12638956,44000000
The Big Wedding,48425971,21819348,26606623,4139148,32500000
The Last Stand,48330757,12050299,36280458,6309041,30000000
She's Out of My League,48298434,31628317,16670117,10549998,20000000
Red Dawn,48164150,44806783,3357367,12213501,65000000
G.I. Jane,48154732,48154732,00000,,50000000
The Preacher's Wife,48093211,48093211,00000,,00000
Single White Female,48017402,48017402,00000,,00000
Welcome to Dongmakgol,48000000,00000,48000000,,00000
Scott Pilgrim vs. The World,47969723,31524275,16445448,18756257,85000000
Sutekina kanashibari,47966182,00000,47966182,,00000
Sunny,47958698,00000,47958698,,00000
Aeon Flux,47953341,25857987,22095354,21991031,55000000
The Natural,47951979,47951979,00000,,00000
The Blue Lagoon,47923795,47923795,00000,,4500000
High Fidelity,47881663,27277055,20604608,,20000000
Secondhand Lions,47855342,42023715,5831627,,30000000
A Lot Like Love,47835784,21835784,26000000,,25000000
Trouble with the Curve,47818913,35763137,12055776,13693206,60000000
Arthur,47787943,33035397,14752546,4765808,40000000
Shutter,47782426,25928550,21853876,7618839,8000000
Prem Ratan Dhan Payo,47728805,4328805,43400000,,00000
Book of Shadows: Blair Witch 2,47721314,26421314,21300000,,15000000
Hachiko: A Dog's Story,47707417,00000,47707417,5709208,16000000
The Dead End,47670000,00000,47670000,,00000
Texas Chainsaw 3D,47666013,34341945,13324068,3508164,20000000
The World's End,47508505,26004851,21503654,2892519,20000000
George A. Romero's Land of the Dead,47484873,20433940,27050933,,18975000
An American Tail,47483002,47483002,00000,,00000
The Rescuers Down Under,47431461,27931461,19500000,,00000
Crazy Heart,47409815,39464306,7945509,15693809,8500000
Man on the Moon,47407635,34580635,12827000,,52000000
Tightrope,47392179,47392179,00000,,00000
Hard To Kill,47381386,47381386,00000,,00000
Almost Famous,47371191,32522352,14848839,,60000000
Walking Tall,47313824,46213824,1100000,,56000000
CJ7,47300771,206678,47094093,,20000000
Darkness Falls,47289758,32539681,14750077,,7000000
Airport 1975,47285152,47285152,00000,,00000
The Watcher,47267829,28946615,18321214,,33000000
Soul Surfer,47158652,43853424,3305228,17131245,18000000
The Toy,47118057,47118057,00000,,00000
The Fantastic Mr. Fox,47085064,21002919,26082145,15615786,40000000
The Wedding Date,47033343,31585300,15448043,,15000000
Meitantei Conan: Chinmoku no kuôtâ,47024973,00000,47024973,,00000
Dabangg,47017018,1288549,45728469,,00000
The Place Beyond the Pines,47011449,21403519,25607930,3923923,15000000
Xiong Chumo Zhi Xueling Xiongfeng,47000000,00000,47000000,,00000
Desu Noto 2,47000000,00000,47000000,,00000
Urban Cowboy,46918287,46918287,00000,,00000
"See No Evil, Hear No Evil",46900000,46900000,00000,,00000
Chef,46829309,31424004,15405305,4798708,00000
Deck the Halls,46815807,35093569,11722238,29044409,51000000
Death at a Funeral,46790428,8580428,38210000,,20000000
Fortress,46730578,6730578,40000000,,12000000
Get Rich or Die Tryin',46666955,30981850,15685105,19029304,40000000
Dog Day Afternoon,46665856,46665856,00000,,00000
The Wrestler,46634275,26238243,20396032,12327323,6000000
Colors,46616067,46616067,00000,,00000
Look Who's Talking Too,46614448,46614448,00000,,00000
The Debt,46604054,31177548,15426506,7071334,20000000
Bangkok Dangerous,46598133,15298133,31300000,18829064,45000000
The Rocketeer,46573027,46573027,00000,,00000
The Brady Bunch Movie,46532720,46532720,00000,,00000
How the West Was Won,46500000,46500000,00000,,00000
Machete,46370970,26593646,19777324,17135906,12500000
The Nativity Story,46309644,37629831,8679813,26394827,35000000
Under the Sea 3D,46277977,34777977,11500000,,00000
Miracle on 34th Street,46274068,17174068,29100000,,00000
Des Hommes et Des Dieux,46263525,3954651,42308874,,5000000
Goodfellas,46261759,46261759,00000,,25000000
Entourage,46225326,32363404,13861922,909294,30000000
Legal Eagles,46210024,46210024,00000,,40000000
The Enforcer,46200000,46200000,00000,,00000
The Paper,46184490,36584490,9600000,,00000
Torque,46176322,21176322,25000000,,40000000
The Big Lebowski,46129927,17439163,28690764,,15000000
Napoleon Dynamite,46122713,44540956,1581757,,400000
Deliverance,46122355,46122355,00000,,00000
For Love of the Game,46112640,35188640,10924000,,50000000
One Fine Day,46112540,46112540,00000,,00000
A Walk to Remember,46060915,41227069,4833846,,11000000
Malice,46038636,46038636,00000,,00000
The Nanny Diaries,45991195,25926673,20064522,37949833,00000
Mr. Brooks,45989012,28476219,17512793,29923719,00000
Zan men jie hun ba,45881996,461996,45420000,,00000
The Breakfast Club,45875171,45875171,00000,,00000
"Greystoke: The Legend of Tarzan, Lord of the Apes",45858563,45858563,00000,,00000
The Rainmaker,45856732,45856732,00000,,40000000
Brewster's Millions,45800000,40800000,5000000,,00000
Firefox,45785720,45785720,00000,,21000000
Take Off,45743246,00000,45743246,,00000
Addams Family Values,45703556,45703556,00000,,00000
Man on a Ledge,45688337,18620000,27068337,5535473,42000000
RoboCop 2,45681173,45681173,00000,,00000
Hot Pursuit,45680201,34580201,11100000,6826373,35000000
You yi ge di fang zhi you wo men zhi dao,45642013,482013,45160000,,00000
New Jack City,45634270,45634270,00000,,00000
Dancer in the Dark,45557491,4157491,41400000,,12500000
Fletch,45488983,45488983,00000,,00000
The Last House on the Left,45482936,32752215,12730721,20597258,15000000
Kokowaah,45424636,00000,45424636,,00000
Hero,45422548,84961,45337587,,00000
Grizzly Adams,45411063,45411063,00000,,00000
Thelma & Louise,45361000,45361000,00000,,00000
Keeping the Faith,45336404,37036404,8300000,,29000000
Wei ai zhi jian ru jia jing,45331734,271734,45060000,,00000
The Dirty Dozen,45300000,45300000,00000,,00000
Good Boy!,45299252,37654781,7644471,,17000000
Eunmilhage Widaehage,45286922,00000,45286922,,00000
Léon,45284974,19284974,26000000,,16000000
Wayne's World 2,45264562,45264562,00000,,00000
Cold War,45249153,00000,45249153,,00000
The Duchess,45160110,13848978,31311132,11480687,27000000
Deuce Bigalow: European Gigolo,45137797,22264487,22873310,,22000000
Brothers,45043870,28544157,16499713,10964893,26000000
The Hunted,45016494,34234008,10782486,,55000000
Full Metal Jacket,45015999,45015999,00000,,00000
Notorious,45005151,36843682,8161469,29638296,19000000
Deep Throat,45000000,45000000,00000,,25000
Convoy,45000000,45000000,00000,,00000
Medicine Man,44948240,44948240,00000,,40000000
Scarface,44942821,44942821,00000,15291108,25000000
D2: The Mighty Ducks,44831717,44831717,00000,,00000
Lakeview Terrace,44821299,39263506,5557793,22277161,20000000
A Nightmare On Elm Street 3: Dream Warriors,44793222,44793222,00000,,5000000
Home,44793168,15433,44777735,,500000
Midnight Cowboy,44785053,44785053,00000,,3600000
Cobra,44769650,44769650,00000,,00000
Young Guns,44726644,44726644,00000,,13000000
Malcolm X,44707772,44707772,00000,,35000000
Jeremiah Johnson,44693786,44693786,00000,,00000
Neuk-dae-so-nyeon,44685170,342922,44342248,,00000
Magnum Force,44680473,44680473,00000,,00000
"McFarland, USA",44633422,44480275,153147,4892401,17000000
Meet Joe Black,44606335,44606335,00000,,85000000
The Gift,44567606,12008642,32558964,,10000000
Ra. One,44549121,2509150,42039971,,00000
The Odd Couple,44527234,44527234,00000,,00000
One Missed Call,44513466,26890041,17623425,14376615,20000000
The Good Son,44456478,44456478,00000,,00000
Recess: School's Out,44451470,36696761,7754709,,10000000
Valley of the Dolls,44432255,44432255,00000,,00000
The Shining,44414369,44017374,396995,,19000000
Push,44411527,31811527,12600000,16991379,38000000
Bereurlin,44403920,00000,44403920,74833,00000
Clash of the Titans,44400000,30000000,14400000,,15000000
The Sisterhood of the Traveling Pants 2,44270131,44089964,180167,15510477,27000000
The Postman Always Rings Twice,44200000,12200000,32000000,,12000000
Shi Yue Wei Cheng,44195779,00000,44195779,,23000000
Oculus,44115496,27695246,16420250,2732152,5000000
House at the End of the Street,44103982,31611916,12492066,8315521,6900000
The Boy in the Striped Pajamas,44083403,9046156,35037247,12422580,12500000
Passenger 57,44065653,44065653,00000,,00000
Semi-Pro,43980363,33479698,10500665,27086902,55000000
Exorcist: The Beginning,43957541,41814863,2142678,,78000000
Dogma,43948865,30651422,13297443,,10000000
The Transporter,43928932,25296447,18632485,,21000000
Crank,43924923,27838408,16086515,44594467,12000000
_kami Kodomo no Ame to Yuki,43909923,00000,43909923,,00000
The One,43905746,43905746,00000,,49000000
Love at First Bite,43900000,43900000,00000,,00000
The Fox and the Hound,43899231,43899231,00000,38856315,00000
Wall Street,43848100,43848100,00000,,16500000
A Man Apart,43797731,26500000,17297731,,36000000
Monster's Ball,43766463,31273922,12492541,,4000000
Hardball,43728560,40222729,3505831,,21000000
West Side Story,43700000,43700000,00000,,6000000
The Distinguished Gentleman,43659502,43659502,00000,,00000
Freedom Writers,43632609,36605602,7027007,20632006,21000000
Going the Distance,43603990,17804299,25799691,,32000000
Max,43553101,42656255,896846,2608130,20000000
We Are Marshall,43545364,43545364,00000,28007966,65000000
Fly Me To the Moon,43530281,14543943,28986338,,25000000
The DUFF,43528634,34030343,9498291,4609142,8500000
Soul Food,43490057,43490057,00000,,7500000
City Slickers II: The Legend of Curly's Gold,43440947,43440947,00000,,00000
Pride and Glory,43440721,15740721,27700000,12139651,30000000
Harold & Kumar Escape from Guantanamo Bay,43353117,38108728,5244389,30319498,12000000
Sur la piste du Marsupilami,43343964,00000,43343964,,00000
Last Holiday,43343247,38399961,4943286,30434196,45000000
Raising Helen,43340302,37485528,5854774,,50000000
Welcome Home Roscoe Jenkins,43339555,42168445,1171110,22874170,27500000
Orange County,43308707,41059716,2248991,,18000000
Girl with a Pearl Earring,43281552,11634362,31647190,,12000000
Midway,43220000,43220000,00000,,00000
Black Rain,43140147,43140147,00000,,30000000
Boogie Nights,43085873,26384919,16700954,,15000000
See Spot Run,43057552,33357476,9700076,,16000000
The Jungle Book,43054607,43054607,00000,,27000000
Tom yum goong,43044087,12044087,31000000,13293888,5700000
The Longest Yard,43008075,43008075,00000,,00000
Regarding Henry,43001500,43001500,00000,,00000
Escape from Alcatraz,43000000,43000000,00000,,8000000
Meatballs,43000000,43000000,00000,,00000
California Suite,42913571,42913571,00000,,00000
Glory Road,42799060,42647449,151611,50751309,30000000
Just Friends,42797679,32596916,10200763,24567802,00000
The Uninvited,42778961,28596818,14182143,11994510,00000
Shaolin Soccer,42776032,488872,42287160,,10000000
Heartbreak Ridge,42724017,42724017,00000,,00000
The Electric Horseman,42670138,42670138,00000,,00000
Basic,42598498,26599248,15999250,,50000000
Pokemon 2008,42563360,00000,42563360,,00000
Child's Play,42557639,31605639,10952000,,9000000
A Walk Among the Tombstones,42517685,26017685,16500000,6049768,28000000
The Four Seasons,42488161,42488161,00000,,6500000
To Sir With Love,42432803,42432803,00000,,00000
Mask,42417782,42417782,00000,,00000
Forever Young,42380914,149761,42231153,,00000
8 femmes,42376425,3076425,39300000,,8000000
The Bad News Bears,42349782,42349782,00000,,00000
My Name is Khan,42327961,4018771,38309190,,8470000
Blue Thunder,42313354,42313354,00000,,00000
Bullitt,42300873,42300873,00000,,00000
Chi zi Xi zi Pi zi,42280000,00000,42280000,,00000
Teenage Mutant Ninja Turtles III,42273609,42273609,00000,,21000000
Defiance,42268745,28644813,13623932,15090981,50000000
Jaws 3-D,42245180,42245180,00000,,00000
Joheunnom nabbeunnom isanghannom,42226657,128486,42098171,,10000000
Police Academy 3: Back in Training,42223193,42223193,00000,,00000
21 and Over,42195766,25682380,16513386,5858684,13000000
Dabangg 2,42165098,2474674,39690424,,00000
White Nights,42160849,42160849,00000,,00000
In the Bedroom,42137871,35930604,6207267,,1700000
A Good Year,42064105,7459300,34604805,15092868,35000000
Dirty Rotten Scoundrels,42039000,42039000,00000,,00000
Gamer,42002029,20534907,21467122,11779979,50000000
Around the World in 80 Days,42000000,42000000,00000,,6000000
Meet the Browns,41975388,41975388,00000,22628621,20000000
Quarantine,41924774,31691811,10232963,14859240,12000000
The Walk,41913749,10137502,31776247,,35000000
Meitantei Conan: Juichi-ninme no Striker,41863105,00000,41863105,,00000
The Return of the Pink Panther,41833347,41833347,00000,,5000000
Homeward Bound: The Incredible Journey,41833324,41833324,00000,,00000
"As Above, So Below",41799626,21222315,20577311,114160,5000000
The Fisher King,41798224,41798224,00000,,24000000
The Informant!,41771168,33316821,8454347,6885577,22000000
Casino Royale,41744718,22744718,19000000,,12000000
Easy Rider,41728598,41728598,00000,,00000
Still Alice,41699612,18656400,23043212,2121465,5000000
Cheech & Chong's Next Movie,41675194,41675194,00000,,00000
Sado,41672989,00000,41672989,,00000
Into the Blue,41672363,18472363,23200000,,50000000
Wimbledon,41666476,16862585,24803891,,35000000
Astro Boy,41636243,19551067,22085176,9669273,65000000
Up in Smoke,41590893,41590893,00000,,00000
Meitantei Conan: Chinmoku No 15 Fun,41545553,00000,41545553,,00000
The Sisterhood of the Traveling Pants,41515797,39008741,2507056,,25000000
Three Days of the Condor,41509797,41509797,00000,,00000
A River Runs Through It,41504974,41504974,00000,,00000
Safe,41495213,17142080,24353133,5911209,33000000
Gremlins 2: The New Batch,41476097,41476097,00000,,50000000
Dredd,41467606,13414714,28052892,11140218,45000000
Gridiron Gang,41457834,38432823,3025011,39227539,30000000
The Great Outdoors,41455230,41455230,00000,,00000
Ghajini,41430631,2430631,39000000,,00000
Pale Rider,41410568,41410568,00000,,6900000
The Gallows,41364410,22764410,18600000,533749,100000
Man of the Year,41342180,37442180,3900000,25126974,20000000
50/50,41332809,35014192,6318617,8130223,8000000
Cabaret,41326446,41326446,00000,,00000
Gosford Park,41300105,41300105,00000,,18000000
This is Where I Leave You,41296320,34296320,7000000,2953156,20000000
The Mirror Has Two Faces,41252428,41252428,00000,,42000000
Leatherheads,41204865,31230175,9974690,12934437,58000000
Private Parts,41198146,41198146,00000,,00000
Luftslottet som sprängdes,41179660,5427684,35751976,7653789,00000
The French Connection,41158757,41158757,00000,,2200000
Money Talks,41067398,41067398,00000,,25000000
Poltergeist II: The Other Side,40996665,40996665,00000,,00000
Don Jon,40993475,24477704,16515771,4074924,5500000
Happy Gilmore,40982952,38602000,2380952,,10000000
30 Minutes or Less,40966716,37053924,3912792,11672943,28000000
Pokemon 2009,40952392,00000,40952392,,00000
Pee Wee's Big Adventure,40940662,40940662,00000,,00000
Falling Down,40903593,40903593,00000,,00000
Drive Angry,40886464,10721033,30165431,4973800,50000000
Balls of Fury,40878622,32886940,7991682,19180803,00000
Revenge of the Nerds,40870674,40870674,00000,,00000
Where the Heart Is,40862054,33771174,7090880,,15000000
Focus,40851841,719901,40131940,,00000
Undercover Brother,40796145,38230435,2565710,,25000000
Broken Flowers,40744960,13744960,27000000,,00000
Short Circuit,40697761,40697761,00000,,00000
War,40686409,22486409,18200000,27507988,25000000
The Dark Crystal,40577001,40577001,00000,,00000
El secreto de sus ojos,40527719,6391436,34136283,,3500000
Fright Night,40520649,18298649,22222000,5176678,30000000
Jagged Edge,40491165,40491165,00000,,00000
Young Guns II,40478635,40478635,00000,,00000
The Ringer,40442437,35428675,5013762,19011297,00000
Bless the Child,40435694,29374178,11061516,,40000000
Foul Play,40415179,40415179,00000,,00000
02010,40400657,40400657,00000,,00000
Swiss Family Robinson,40400000,40400000,00000,,00000
The Master of Disguise,40363530,40363530,00000,,16000000
La mala educación,40311842,5211842,35100000,,5000000
The Last Emperor,40295591,40295591,00000,,25000000
Marked for Death,40228288,40228288,00000,,00000
Mo' Money,40190000,40190000,00000,,00000
Big Business,40150487,40150487,00000,,00000
The Invasion,40147042,15074191,25072851,4880728,80000000
Serenity,40140858,25335935,14804923,,39000000
All About Steve,40127259,33862903,6264356,8041395,15000000
The Love Guru,40123346,32200122,7923224,9552426,62000000
Twisted,40119848,25195050,14924798,,50000000
Scoop,40107018,10525717,29581301,,4000000
Encounter in the Third Dimension,40102213,7195792,32906421,,00000
Grand Canyon,40098309,32350000,7748309,,00000
Ricki and the Flash,40093123,26822144,13270979,,00000
Hannah and Her Sisters,40084041,40084041,00000,,00000
The Faculty,40064955,40064955,00000,,15000000
Encino Man,40057130,40057130,00000,,00000
Funny Lady,40055897,40055897,00000,,00000
Man of the House,40029009,40029009,00000,,00000
Thank You For Smoking,40016662,24793509,15223153,16707096,7500000
I Still Know What You Did Last Summer,39989088,39989088,00000,,24000000
The Secret Life of Bees,39984023,37770162,2213861,17389194,11000000
Manhattan,39946780,39946780,00000,,00000
Dream House,39932340,21302340,18630000,4320276,50000000
Magnificent Desolation,39846896,34126126,5720770,,00000
Caddyshack,39846344,39846344,00000,,6000000
The Beach,39778599,39778599,00000,,50000000
Cirque du Freak: The Vampire's Assistant,39753957,14046595,25707362,8626662,40000000
Pokemon 2007: Diamond & Pearl,39739776,00000,39739776,,00000
Memento,39709113,25530884,14178229,,5000000
When in Rome,39692267,32680633,7011634,9449490,00000
Monte Carlo,39686769,23186769,16500000,10058580,20000000
Mar adentro,39686345,2086345,37600000,,13300000
Dhoom 2,39643586,2643586,37000000,,00000
Mars Needs Moms,39549758,21392758,18157000,3838350,150000000
Sin City: A Dame to Kill For,39499349,13757804,25741545,3325788,65000000
Dreamer: Inspired by a True Story,39498360,33022286,6476074,48950966,32000000
Overheard 2,39479263,00000,39479263,,00000
Three Fugitives,39395321,39395321,00000,,00000
Crocodile Dundee in Los Angeles,39393111,25590119,13802992,,25000000
Becoming Jane,39380876,18663911,20716965,8871778,16500000
Nobody's Fool,39375493,39375493,00000,,00000
Whale Rider,39374600,20779666,18594934,,4300000
Hocus Pocus,39360491,39360491,00000,,28000000
Furry Vengeance,39340177,17630465,21709712,7363131,35000000
Never Back Down,39319801,24850922,14468879,23684416,21000000
Partners: The Movie,39314819,00000,39314819,,00000
Anna and the King,39251128,39251128,00000,,75000000
Three Amigos,39246734,39246734,00000,,00000
The Legend of Bagger Vance,39235486,30695227,8540259,,60000000
Brooklyn's Finest,39233233,27163593,12069640,10676680,17000000
No Escape,39155092,27288872,11866220,,5000000
Roxanne,39148164,39148164,00000,,00000
Don't Be Afraid of the Dark,39126427,24046682,15079745,4690913,25000000
Ex Files 2: The Backup Strikes Back,39123790,00000,39123790,,00000
What's Love Got to Do With It,39100956,39100956,00000,,15000000
Yentl,39012241,39012241,00000,,12000000
The Spirit,39006188,19806188,19200000,23821819,60000000
Agora,38992292,619423,38372869,,70000000
Primary Colors,38966057,38966057,00000,,65000000
Peggy Sue Got Married,38948832,38948832,00000,,18000000
National Lampoon's Van Wilder,38941393,21005329,17936064,,6000000
Earth to Echo,38934842,38934842,00000,6180396,13000000
Romeo and Juliet,38901218,38901218,00000,,00000
The Warlords,38899792,129078,38770714,,40000000
Dnevnoy dozor,38870910,459095,38411815,4246151,00000
Doragon B_ru Zetto Kami to Kami,38848780,00000,38848780,,00000
Clockstoppers,38788828,36985501,1803327,,26000000
Nightcrawler,38781218,32381218,6400000,2407213,8500000
Little Shop of Horrors,38747385,38747385,00000,,30000000
Redi,38734626,934951,37799675,,00000
About Last Night...,38702310,38702310,00000,,00000
Someone Like You,38684906,27338033,11346873,,23000000
On Deadly Ground,38590458,38590458,00000,,50000000
Koltchak,38585047,00000,38585047,,20000000
The Gambler,38580992,33680992,4900000,2812458,25000000
Urban Legends: Final Cut,38574362,21468807,17105555,,15000000
The Ghost and the Darkness,38553833,38553833,00000,,55000000
The Piano,38513715,38513715,00000,,7000000
Halloween 2,38512850,33392973,5119877,9227352,15000000
Ting Feng Zhe,38503726,00000,38503726,,00000
Running Scared,38500726,38500726,00000,16638855,00000
What's the Worst That Could Happen?,38462071,32267774,6194297,,30000000
Pretty in Pink,38441560,38441560,00000,,00000
Bachelor Party,38435947,38435947,00000,,00000
Chernobyl Diaries,38390020,18119640,20270380,4636116,1000000
The Soloist,38389024,31720158,6668866,10967115,60000000
Bang Bang,38381138,2581138,35800000,,00000
Employee of the Month,38364855,28444855,9920000,22685139,10000000
Beauty Shop,38351350,36351350,2000000,,25000000
City Heat,38348988,38348988,00000,,00000
After the Sunset,38329114,28328132,10000982,,57000000
N.L.L: Yeonpyeong Haejeon,38324719,324719,38000000,,00000
Head of State,38283765,37788228,495537,,35200000
The Missing,38253433,26900336,11353097,,65000000
Annie Hall,38251425,38251425,00000,,4000000
The Original Kings of Comedy,38236338,38168022,68316,,3000000
Winged Migration,38208108,10762178,27445930,,28000000
The In-Laws,38200000,38200000,00000,,00000
Starting Over,38200000,38200000,00000,,00000
Joe Versus the Volcano,38169803,38169803,00000,,00000
Just My Luck,38159905,17326650,20833255,11128446,28000000
Jumping the Broom,38158601,37295394,863207,8848189,7000000
The Covenant,38142105,23342105,14800000,26572026,20000000
Ex Machina,38132136,25440971,12691165,3386877,13000000
Killing Them Softly,38123368,14945541,23177827,4238521,15000000
Quest for Camelot,38117758,22717758,15400000,,40000000
First Sunday,38113408,37931869,181539,22753144,00000
Carnage,38112154,2546747,35565407,,25000000
The Banger Sisters,38067218,30306281,7760937,,10000000
Ri&cent;hie Ri&cent;h,38059575,38059575,00000,,40000000
Accepted,38058225,36323505,1734720,38039328,00000
Beastly,38028230,27865571,10162659,7009144,17000000
Higher Learning,38023585,38023585,00000,,00000
Tequila Sunrise,38022210,38022210,00000,,00000
Mannequin,38018000,38018000,00000,,00000
For Colored Girls,38017873,37729698,288175,18978489,21000000
Negotiator (Bayside Shakedown 3),38000000,00000,38000000,,00000
"The Karate Kid, Part III",37995331,37995331,00000,,00000
Postcards from the Edge,37963281,37963281,00000,,00000
Happily N'Ever After,37923818,15849032,22074786,16702105,47000000
The Dead Pool,37903000,37903000,00000,,00000
Red Dawn,37890177,37890177,00000,15518211,00000
All That Jazz,37823676,37823676,00000,,00000
The Black Stallion,37799643,37799643,00000,,2700000
Bill & Ted's Excellent Adventure,37788317,37788317,00000,,10000000
Mighty Morphin Power Rangers: The Movie,37765144,37765144,00000,,00000
The Running Man,37743350,37743350,00000,,30000000
Om Shanti Om,37743074,3597372,34145702,,00000
Sgt. Bilko,37741475,30141475,7600000,,39000000
The Wicker Man,37721827,24413467,13308360,,00000
How Stella Got Her Groove Back,37672350,37672350,00000,,20000000
Halloween: Resurrection,37659652,30259652,7400000,,15000000
Emma,37641742,22041742,15600000,,5900000
Beverly Hills Ninja,37629395,31235710,6393685,,00000
Tom Jones,37600000,37600000,00000,,1000000
St. Elmo's Fire,37589817,37589817,00000,,00000
The Fly,37585000,37585000,00000,,00000
Showgirls,37570437,20170437,17400000,,40000000
Bill & Ted's Bogus Journey,37537675,37537675,00000,,20000000
Blind Date,37522732,37522732,00000,,00000
The Money Pit,37499651,37499651,00000,,00000
The Doctor,37497480,37497480,00000,,00000
The Boat That Rocked,37472651,8017467,29455184,4078550,50000000
The Hills Have Eyes II,37466538,20804166,16662372,30696198,15000000
Oliver!,37402877,37402877,00000,,10000000
Time Bandits,37400000,37400000,00000,,12000000
Gomorra,37339594,1579146,35760448,,6200000
Revenge of the Pink Panther,37337746,37337746,00000,,00000
The Majestic,37306334,27796042,9510292,,72000000
The Main Event,37198813,37198813,00000,,00000
Semi-Tough,37187139,37187139,00000,,00000
Out for Justice,37180077,37180077,00000,,00000
The Guilt Trip,37134215,37134215,00000,7685734,40000000
Brubaker,37121708,37121708,00000,,00000
The Family That Preys,37105289,37105289,00000,28733770,00000
Uptown Girls,37095657,37095657,00000,,00000
Women Who Flirt,37094116,374116,36720000,,00000
Jersey Girl,37066129,25266129,11800000,,35000000
Psycho,37065220,21380220,15685000,,20000000
The Fog,37048526,29511112,7537414,,18000000
Yi Sheng Yi Shi,37007558,417558,36590000,,00000
Gekij_ban Poketto Monsut_ Adobansu Jener_shon My_ to Had_ no Y_sha Rukario,37000000,00000,37000000,,00000
Verite si je mens! 3 la,36960781,00000,36960781,,00000
Million Dollar Arm,36947959,36447959,500000,3699188,25000000
It Could Happen To You,36901812,36901812,00000,,00000
The Bachelor,36882378,21731001,15151377,,21000000
Zack and Miri Make a Porno,36856306,31457946,5398360,21753091,24000000
My Favorite Martian,36850101,36850101,00000,,60000000
Kiss of the Dragon,36833473,36833473,00000,,25000000
Just Cause,36830090,36830090,00000,,00000
South Pacific,36800000,36800000,00000,,00000
Natale in Crociera,36773534,00000,36773534,,00000
Barfi,36751984,2804874,33947110,,4600000
Titan A.E.,36751979,22751979,14000000,,75000000
K-9,36746272,36746272,00000,,00000
The Getaway,36734619,36734619,00000,,00000
Spaceballs,36725144,36725144,00000,,22700000
Eight Legged Freaks,36722311,17266505,19455806,,30000000
Disaster Movie,36720752,14190901,22529851,10948002,20000000
The Sword and the Sorcerer,36714025,36714025,00000,,00000
Best Friends,36670556,36670556,00000,,00000
Dead Again,36649419,36649419,00000,,00000
Gamshijadeul,36599303,00000,36599303,,00000
"Tarzan, The Ape Man",36565000,36565000,00000,,00000
Sicko,36535837,24538513,11997324,61344193,9000000
Hotel Rwanda,36521223,23519128,13002095,,17500000
Soapdish,36489888,36489888,00000,,00000
Vegas Vacation,36429528,36429528,00000,,00000
"To Wong Foo Thanks for Everything, Julie Newmar",36422690,36422690,00000,,00000
Delivery Man,36418006,30659817,5758189,4602626,22000000
Sumbakkokjil,36412217,00000,36412217,,00000
Haywire,36374700,18942396,17432304,6784613,23000000
The Glimmer Man,36301706,20301706,16000000,,45000000
The Adventures of Pinocchio,36288577,14988577,21300000,,25000000
The Kids Are All Right,36275469,20811365,15464104,,4000000
A Very Harold & Kumar 3D Christmas,36265745,35061031,1204714,6403198,20000000
Rumble in the Bronx,36238752,32281907,3956845,,7500000
Mad Max Beyond Thunderdome,36230219,36230219,00000,,10000000
Casanova,36204403,11304403,24900000,15718314,00000
Across The Sea of Time,36203843,16003309,20200534,,00000
One for the Money,36197221,26414527,9782694,9430742,42000000
Devil's Due,36146087,15821461,20324626,2490462,7000000
Silent Movie,36145695,36145695,00000,,4400000
Last Tango in Paris,36144824,36144824,00000,,00000
Love Happens,36133014,22965110,13167904,8570743,18000000
Always 3 Chome no yuhi '64 3,36119625,00000,36119625,,00000
A Most Wanted Man,36068890,17237855,18831035,1178060,15000000
The Eagle,36054706,19490041,16564665,5483397,25000000
Set It Off,36049108,36049108,00000,,9000000
Assault On Precinct 13,36040895,20040895,16000000,,30000000
Garden State,36028802,26782316,9246486,,2500000
The Greatest Show on Earth,36000000,36000000,00000,,4000000
The Born Losers,36000000,36000000,00000,,00000
Pete's Dragon,36000000,36000000,00000,,10000000
The Robe,36000000,36000000,00000,,5000000
Nana,36000000,00000,36000000,,00000
Breakin',35995234,35995234,00000,,00000
What a Girl Wants,35990505,35990505,00000,,25000000
Fly Away Home,35870837,24545333,11325504,,00000
Wu ji,35869934,669625,35200309,,30000000
Miss Potter,35861301,2975649,32885652,16703708,30000000
Taps,35856053,35856053,00000,,14000000
The Black Hole,35841901,35841901,00000,,20000000
Arbitrage,35830713,7919574,27911139,,12000000
Shine,35811509,35811509,00000,,5500000
My Dog Skip,35795319,34099640,1695679,,7000000
Faster,35792945,23240020,12552925,13917004,24000000
Toy Story 3D Double Feature,35758775,30593152,5165623,,00000
Murder on the Orient Express,35733867,35733867,00000,,00000
The China Syndrome,35708042,35708042,00000,,00000
Robin Hood: Men in Tights,35699287,35699287,00000,7121066,00000
Other People's Money,35682000,35682000,00000,,00000
"Sex, Lies, and Videotape",35676707,23676707,12000000,,1200000
Father's Day,35659604,28659604,7000000,,85000000
The Indian in the Cupboard,35621764,35621764,00000,,45000000
Silkwood,35615609,35615609,00000,,00000
Tyler Perry's Good Deeds,35579177,35025791,553386,11777270,14000000
Carlito's Way,35577952,35577952,00000,,00000
Crank 2: High Voltage,35472739,13684249,21788490,19223111,20000000
Down with Love,35449905,20298207,15151698,,00000
Selena,35422828,35422828,00000,,20000000
Basic Instinct 2,35417162,5946136,29471026,9067325,70000000
The Gauntlet,35400000,35400000,00000,,00000
Legend,35394757,585707,34809050,,00000
The `Burbs,35382246,35382246,00000,,00000
A Goofy Movie,35323408,35323408,00000,,00000
All of Me,35243581,35243581,00000,,00000
EDtv,35232087,22421087,12811000,,60000000
Honeymoon in Vegas,35208854,35208854,00000,,00000
Alfie,35195939,13395939,21800000,,40000000
Courageous,35185884,34522221,663663,20369657,2000000
Born to be Wild 3D,35146233,24428506,10717727,2799622,00000
Mermaids,35140500,35140500,00000,,00000
The Adventures of Rocky & Bullwinkle,35129610,26000610,9129000,,76000000
Die Welle,35122948,00000,35122948,,7250000
Summer School,35114428,35114428,00000,,00000
Dragon: The Bruce Lee Story,35112679,35112679,00000,,00000
Whatever Works,35106706,5306706,29800000,,15000000
The Darjeeling Limited,35073751,11897548,23176203,9747534,00000
Shaolin,35066099,66099,35000000,,00000
Gung Ho,35021606,35021606,00000,,00000
The Skulls,35007180,35007180,00000,,15000000
Giant,35000000,35000000,00000,,00000
Midnight Express,35000000,35000000,00000,,00000
Red Heat,34994648,34994648,00000,,00000
Richard Pryor Live on the Sunset Strip,34970309,34970309,00000,,00000
Camping 2,34959667,00000,34959667,,00000
L'arnacouer,34936771,504030,34432741,,00000
No Way Out,34903810,34903810,00000,,00000
Places in the Heart,34900814,34900814,00000,,00000
The Bible,34900023,34900023,00000,,00000
Commando,34896317,34896317,00000,,10000000
A Thin Line Between Love & Hate,34873513,34873513,00000,,8000000
The November Man,34820335,25018119,9802216,851664,15000000
The Life Aquatic with Steve Zissou,34806726,24006726,10800000,,50000000
My Best Friend's Girl,34787111,19219250,15567861,19492529,20000000
White Fang,34729091,34729091,00000,,14000000
Sammy's avonturen 2,34715056,00000,34715056,3575264,00000
The Other Side of the Mountain,34673100,34673100,00000,,00000
Addicted To Love,34656904,34656904,00000,,00000
Nixon,34642684,13642684,21000000,,45000000
Endless Love,34614964,23438250,11176714,3748152,20000000
The Killing Fields,34609720,34609720,00000,,00000
Mississippi Burning,34603000,34603000,00000,,00000
Everyone Says I Love You,34588635,9714482,24874153,,20000000
The Best Man,34572780,34102780,470000,,9000000
Twentieth Century Boys,34571688,00000,34571688,,00000
Hawaii,34562222,34562222,00000,,15000000
Jack Frost,34545030,34545030,00000,,50000000
In Bruges,34533783,7800825,26732958,4711975,15000000
That Thing You Do!,34509813,25809813,8700000,,2500000
Woodstock,34505110,34505110,00000,,600000
Malibu's Most Wanted,34499204,34308901,190303,,15000000
Heat,34493095,34493095,00000,,00000
Last Chance Harvey,34487202,14889042,19598160,7848872,00000
"Na xie nian, wo men yi qi zhui de nu hai",34480452,00000,34480452,,00000
Breach,34458779,33000880,1457899,31611180,00000
A Walk in the Woods,34444650,29467855,4976795,,00000
Shi gu,34432439,188306,34244133,,00000
Ta-weo,34411903,00726,34411177,,00000
Darkness,34409206,22163442,12245764,,10600000
The Usual Suspects,34380094,23272306,11107788,,6000000
Swimfan,34364995,28564995,5800000,,10000000
"Gone, Baby, Gone",34352162,20300218,14051944,11467525,19000000
Thoroughly Modern Millie,34335025,34335025,00000,,00000
Alive,34327309,34327309,00000,,32000000
Little Darlings,34326249,34326249,00000,,00000
Muppet Treasure Island,34285248,34285248,00000,,00000
Tommy,34251525,34251525,00000,,00000
You Will Meet a Tall Dark Stranger,34247816,3247816,31000000,,15000000
Viy,34246770,00000,34246770,,26000000
My Week with Marilyn,34240572,14597405,19643167,6328323,10000000
Wings of Courage,34240094,15057031,19183063,,00000
Excalibur,34200000,34200000,00000,,00000
Like Father Like Son,34192585,34192585,00000,,00000
Sling Blade,34175000,24475416,9699584,,4833610
Potiche,34152587,1618844,32533743,,00000
Entre les murs,34114067,3766810,30347257,,3250000
Instinct,34105207,34105207,00000,,55000000
The Edge,34079888,27779888,6300000,,00000
Don 2,34053090,3674480,30378610,,00000
Universal Soldier,34035344,34035344,00000,,00000
Freddy's Dead: The Final Nightmare,34015591,34015591,00000,,5000000
Flight of the Phoenix,34009180,21009180,13000000,,75000000
Day of the Dead,34004262,5804262,28200000,,3500000
Bambi II,34000000,00000,34000000,114012839,00000
Friday the 13th Part 3,33985198,33985198,00000,,2250000
Jane Eyre,33983855,11242660,22741195,3750557,00000
Cheech & Chong's Nice Dreams,33982504,33982504,00000,,00000
Wo shi zheng ren,33974305,409644,33564661,,00000
Ne le dis à personne,33954018,6198883,27755135,,18500000
Lockout,33943049,14326865,19616184,6079867,20000000
The Relic,33927476,33927476,00000,,60000000
Nochnoy dozor,33910542,1499188,32411354,9512380,4200000
Magic in the Moonlight,33909396,10534510,23374886,488140,00000
Nick and Norah's Infinite Playlist,33886017,31487293,2398724,10841164,10000000
The Pink Panther Strikes Again,33833201,33833201,00000,,00000
Monkey Magic,33824181,00000,33824181,,00000
Adventures in Babysitting,33790923,33790923,00000,631733,00000
Dungeons and Dragons,33771965,15185241,18586724,,35000000
Jay and Silent Bob Strike Back,33762400,30059386,3703014,,22000000
Porky's II: The Next Day,33759266,33759266,00000,,00000
Always zoku san-chôme no yûhi,33755260,00000,33755260,,00000
Who's Afraid of Virginia Wolf?,33736689,33736689,00000,,00000
The Wizard of Oz,33711566,33711566,00000,,2777000
Y Tu Mamá También,33649881,13649881,20000000,,5000000
Curly Sue,33644430,33644430,00000,,00000
3 Days to Kill,33622417,30697999,2924418,5823822,28000000
Hostel: Part II,33606409,17544812,16061597,16469047,7500000
The Turning Point,33600000,33600000,00000,,00000
Friday After Next,33526835,33253609,273226,,10000000
"Run, Fatboy, Run",33512260,6003262,27508998,5355854,10000000
Because of Winn-Dixie,33506989,32645546,861443,,15000000
The Woman in Black 2: Angel of Death,33501323,26501323,7000000,1658167,00000
The Bad News Bears,33500620,32868349,632271,,35000000
Whiplash,33474334,13092006,20382328,1242391,3300000
Fireproof,33473297,33456317,16980,54284180,500000
Red Planet,33463969,17480890,15983079,,80000000
Mystery Men,33462011,29762011,3700000,,68000000
Nell,33459959,33459959,00000,,00000
Crocodile Hunter: Collision Course,33436931,28436931,5000000,,12500000
The Long Kiss Goodnight,33430951,33430951,00000,,65000000
Black Knight,33422806,33422806,00000,,35000000
Wonder Boys,33422485,19389454,14033031,,35000000
The Doors,33404794,33404794,00000,,40000000
The Planet of the Apes,33395426,33395426,00000,,5800000
Rosemary's Baby,33395426,33395426,00000,,3200000
2016: Obama’s America,33349941,33349941,00000,6940225,2500000
Get on Up,33315804,30569935,2745869,3419644,30000000
...And Justice For All,33300000,33300000,00000,,00000
The Bridge on the River Kwai,33300000,33300000,00000,,3000000
The Truth About Cats & Dogs,33228594,33228594,00000,,00000
"Hello, Dolly",33208099,33208099,00000,,24000000
Forget Paris,33177694,33177694,00000,,00000
Blade Runner,33139618,32656328,483290,,28000000
Confessions of a Teenage Drama Queen,33089883,29302097,3787786,,15000000
Teen Wolf,33086611,33086611,00000,,00000
Matilda,33084249,33084249,00000,,00000
Hart's War,33076815,19076815,14000000,,70000000
The Perks of Being a Wallflower,33069303,17742948,15326355,13707173,13000000
Mr. Woodcock,33035245,25799486,7235759,11246383,00000
Confessions of a Dangerous Mind,33009663,16003576,17006087,,29000000
Dracula 2000,33000377,33000377,00000,,28000000
Heroes,33000000,33000000,00000,,00000
Endless Love,33000000,33000000,00000,,00000
The Last Dragon,33000000,33000000,00000,,10000000
October Sky,32996618,32570685,425933,,00000
Sharky's Machine,32984898,32984898,00000,,00000
Feng Shang,32977948,00000,32977948,,00000
Awake,32968648,14373825,18594823,13871888,8600000
88 Minutes,32955399,16930884,16024515,13861602,30000000
The Producers: The Movie Musical,32952995,19398532,13554463,5341302,45000000
*batteries not included,32945797,32945797,00000,,00000
Inside Llewyn Davis,32943247,13248209,19695038,1303006,11000000
Mercury Rising,32940507,32940507,00000,,60000000
Air America,32914515,30506847,2407668,,00000
Haunted Castle,32863526,13651656,19211870,,00000
Gantz: Perfect Answer,32855277,00000,32855277,,00000
You Again,32838945,25702053,7136892,10929770,20000000
Fighting,32831707,23091010,9740697,14968630,00000
Za majikku awâ,32813807,00000,32813807,,00000
The Joy Luck Club,32790064,32790064,00000,,00000
Alex Cross,32785147,25888412,6896735,12764070,35000000
Luther,32738814,5781086,26957728,,35000000
Child's Play 2,32721435,25459435,7262000,,13000000
Homeward Bound II:  Lost in San Francisco,32709423,32709423,00000,,00000
Katy Perry: Part of Me,32700439,25326071,7374368,4137100,12000000
The Invention of Lying,32679264,18451251,14228013,5534376,18500000
Dangerous Liaisons,32663833,32663833,00000,,14000000
Return to Me,32662299,32662299,00000,,24000000
Coming Home,32653000,32653000,00000,,3000000
Tommy Boy,32637949,32637949,00000,,00000
The Accidental Tourist,32632000,32632000,00000,,00000
Leap Year,32618920,25918920,6700000,15635221,19000000
Seven Psychopaths,32611979,15024049,17587930,5384534,13500000
Bait 3D,32588670,00000,32588670,,00000
Kabhi Alvida Naa Kehna,32575443,3275443,29300000,,10750000
Harry and the Hendersons,32560613,29760613,2800000,5444924,00000
Murder by Death,32511047,32511047,00000,,00000
Fetih 1453,32481209,00000,32481209,,00000
Fletch Lives,32469977,32469977,00000,,00000
Wan-deuk-i,32466461,00000,32466461,,00000
The Sitter,32457751,30542576,1915175,8107868,25000000
Alpha Dog,32447167,15242450,17204717,12643554,00000
Wild Safari 3D,32446750,16621230,15825520,,00000
Krrish,32430721,1430721,31000000,,10000000
The Sandlot,32416586,32416586,00000,,00000
Being John Malkovich,32382381,22858926,9523455,,13000000
The End,32334477,30354004,1980473,,00000
Kevin Hart: Let Me Explain,32327255,32244051,83204,4757622,2500000
La piel que habito,32300305,3185193,29115112,,00000
Black Sheep,32258130,32258130,00000,,00000
Project Almanac,32248241,22348241,9900000,1474365,12000000
The Gods Must Be Crazy,32237111,27937111,4300000,,00000
Deo Tereo Raibeu,32230953,00000,32230953,,00000
Justin Bieber’s Believe,32226781,6206566,26020215,734849,00000
Shark Night 3D,32209741,18877153,13332588,3100212,25000000
Rowdy Rathore,32208348,777373,31430975,,00000
Agneepath,32186870,1973574,30213296,,00000
Amazing Grace,32183710,21214987,10968723,25597395,00000
Darkman,32177867,32177867,00000,,00000
Bai she chuan shuo,32172621,18759,32153862,2268032,00000
The Lawnmower Man,32100816,32100816,00000,,10000000
Dance Flick,32092761,25662155,6430606,,25000000
Kingpin,32079969,24879969,7200000,,25000000
The Accused,32078318,32078318,00000,,00000
Silverado,32076721,32076721,00000,,26000000
Summer of '42,32063634,32063634,00000,,00000
Cidade de Deus,32059295,7563397,24495898,,3300000
Golmaal 3,32056809,1132192,30924617,,00000
Robin Hood,32056467,32056467,00000,64532274,00000
Sunshine,32017122,3675072,28342050,7296863,40000000
The Age of Innocence,32014993,32014993,00000,,34000000
Psycho,32000000,32000000,00000,,00000
Metro,31987563,31987563,00000,,00000
Jennifer's Body,31943401,16204793,15738608,6175670,16000000
Copycat,31925151,31925151,00000,,20000000
The Apple Dumpling Gang,31916500,31916500,00000,,00000
Dressed to Kill,31899000,31899000,00000,,6500000
Bob & Carol & Ted & Alice,31897253,31897253,00000,,00000
The Young Victoria,31878891,11001272,20877619,5894881,35000000
Children of a Lesser God,31853080,31853080,00000,,00000
The Shadow,31835600,31835600,00000,,40000000
Lake Placid,31770413,31770413,00000,,27000000
Herbie Rides Again,31765098,31765098,00000,,00000
Jungle Fever,31739045,31739045,00000,,00000
Pinocchio,31681811,3681811,28000000,,45000000
Paint Your Wagon,31678778,31678778,00000,,20000000
Mr. Nice Guy,31674183,12674183,19000000,,6000000
History of the World: Part I,31672000,31672000,00000,,11000000
Rent,31670620,29077547,2593073,31477602,40000000
Hard Target,31636358,31636358,00000,,00000
The Girl Next Door,31635150,14589444,17045706,,25000000
For Richer or Poorer,31611225,31611225,00000,,00000
Daddy's Little Girls,31609243,31366978,242265,32422364,00000
Benji,31559560,31559560,00000,,500000
Little Big Man,31559552,31559552,00000,,00000
Mud,31556959,21590086,9966873,6397915,10000000
Benvenuti al nord,31546647,00000,31546647,,00000
Lage Raho Munna Bhai,31517561,2217561,29300000,,2700000
Yomei Ikkagetsu no Hanayome,31510715,00000,31510715,,00000
Three Warriors on Distant Shores,31476575,00000,31476575,,00000
King Ralph,31464470,31464470,00000,,00000
LOL (Laughing Out Loud),31451622,00000,31451622,,00000
The Seeker: The Dark is Rising,31400740,8794452,22606288,13022944,00000
Premium Rush,31393201,20275446,11117755,6891450,35000000
Rob Roy,31341940,31341940,00000,,28000000
An Ideal Husband,31341183,18542974,12798209,,10700000
The Iron Giant,31333917,23159305,8174612,,50000000
Lost Souls,31320293,16779636,14540657,,28000000
Sky of Love,31311079,00000,31311079,,00000
Mrs Brown's Boys D'Movie,31301165,00000,31301165,,00000
Eddie,31289479,31289479,00000,,00000
Johnson Family Vacation,31286759,31203964,82795,,12000000
Thrill Ride: The Science of Fun,31279211,18798682,12480529,,00000
Robot,31267492,2276427,28991065,,00000
Bustin' Loose,31261000,31261000,00000,,00000
Salmon Fishing in the Yemen,31256373,9041540,22214833,,00000
How High,31222395,31155435,66960,,12000000
Jie jiu wu xian sheng,31221927,92696,31129231,,00000
The Great Muppet Caper,31206251,31206251,00000,,00000
The Secret Garden,31181000,31181000,00000,,00000
Chimpanzee,31168243,28965459,2202784,,00000
Movie 43,31164747,8840453,22324294,1876052,10000000
Joyful Noise,31157914,30932113,225801,13324224,27500000
Spring Breakers,31149251,14124286,17024965,3018605,5000000
True Grit,31132592,31132592,00000,,00000
Those Magnificent Men In Their Flying...,31111111,31111111,00000,,00000
Camelot,31102578,31102578,00000,,00000
Les Profs,31090977,00000,31090977,,00000
Love in the Time of Cholera,31077418,4617608,26459810,,45000000
High Anxiety,31063038,31063038,00000,,3400000
Grosse Pointe Blank,31059206,28073151,2986055,,15000000
Picture Perfect,31058643,31058643,00000,,00000
Igor,31013349,19528602,11484747,13266318,22000000
Joe Dirt,30987695,27087695,3900000,,16000000
Ultraviolet,30962112,18522064,12440048,19507355,30000000
Paper Moon,30933743,30933743,00000,,00000
"Vysotsky. Spasibo, Chto Zhivoi",30896024,00000,30896024,,00000
Be Kind Rewind,30894247,11175164,19719083,5268191,20000000
Hearts in Atlantis,30885781,24185781,6700000,,31000000
Zatoichi,30874550,853718,30020832,,00000
The Water Diviner,30864649,4200117,26664532,1479691,22500000
The Princess Bride,30857000,30857000,00000,,15000000
Ryan's Daughter,30846306,30846306,00000,,00000
Murphy's Romance,30762621,30762621,00000,,00000
Powder,30749565,30749565,00000,,00000
Broken City,30746765,19701164,11045601,6052278,35000000
Nancy Drew,30703845,25584685,5119160,11702725,2000000
Young Doctors in Love,30688860,30688860,00000,,00000
Home Alone III,30672357,30672357,00000,,00000
Superstar,30628981,30628981,00000,,14000000
Virus,30626690,14010690,16616000,,75000000
Major League II,30626182,30626182,00000,,00000
The Fighting Temptations,30597073,30238577,358496,,00000
Pathfinder,30561765,9970985,20590780,27521209,00000
Flipper,30561008,20047715,10513293,,25530000
Sleepwalkers,30524763,30524763,00000,,00000
From Here to Eternity,30500000,30500000,00000,,1650000
The Battle of Red Cliff,30500000,00000,30500000,,00000
Psycho II,30451264,30451264,00000,,00000
An American Haunting,30443277,16298046,14145231,9996929,14000000
The Champ,30441738,30441738,00000,,00000
East is East,30438635,4170647,26267988,,3000000
Stick It,30399714,26910736,3488978,27808505,20000000
Mortdecai,30396134,7696134,22700000,1680970,00000
Friday the 13th Part IV: The Final Chapter,30393007,30393007,00000,,2600000
A Wedding Invitation,30364350,14350,30350000,,00000
2 For the Money,30362049,22862049,7500000,,20000000
A Serious Man,30360570,9228788,21131782,4737212,7000000
Cabin Fever,30351664,21158188,9193476,,1500000
The Lost Boys,30331685,30331685,00000,,8500000
Absence of Malice,30331624,30331624,00000,,00000
A Night at the Roxbury,30324946,30324946,00000,,17000000
Queen of the Damned,30307804,30307804,00000,,35000000
Say Yes,30300000,00000,30300000,,00000
Silmido,30298347,298347,30000000,,8500000
The Great Debaters,30261293,30226144,35149,24441834,15000000
Shaun of the Dead,30253899,13464388,16789511,,5000000
Pulse,30241435,20264436,9976999,7576631,20500000
Weekend at Bernie's,30218387,30218387,00000,,00000
The World According to Garp,30207324,30207324,00000,,00000
The Art of War,30199105,30199105,00000,,40000000
Being There,30177511,30177511,00000,,00000
What's Your Number?,30163785,14011084,16152701,4650884,20000000
Jane Austen's Mafia,30143795,19843795,10300000,,10000000
When the Game Stands Tall,30138912,30127963,10949,7872347,15000000
Blown Away,30133002,30133002,00000,,00000
"Che, El Ar the Argentine",30118557,293708,29824849,,58000000
Free Willy 2: The Adventure Home,30066400,30066400,00000,,00000
Dragonfly,30063805,30063805,00000,,60000000
Metegol,30051905,00000,30051905,,22000000
Road House,30050028,30050028,00000,,10000000
The Chaser,30049670,00000,30049670,,00000
Point of No Return,30038362,30038362,00000,,00000
The Sand Pebbles,30017647,30017647,00000,,00000
Rollerball,30000000,30000000,00000,,00000
White Christmas,30000000,30000000,00000,,00000
Airport '77,30000000,30000000,00000,,00000
Chapter Two,30000000,30000000,00000,,00000
Quo Vadis?,30000000,30000000,00000,,8250000
Freebie and the Bean,30000000,30000000,00000,,00000
Night of the Living Dead,30000000,12000000,18000000,,114000
Laws of Attraction,29948322,17848322,12100000,,32000000
New in Town,29937909,16734283,13203626,19088087,8000000
Neighbors,29916207,29916207,00000,,00000
Going in Style,29900000,29900000,00000,,00000
7 Zwerge - Der Wald Ist Nicht Genug,29900000,00000,29900000,,00000
The Four Feathers,29882645,18306166,11576479,,35000000
Shorts,29870801,20919166,8951635,1882225,20000000
The Losers,29863840,23591432,6272408,10086147,25000000
Ghost Town,29843245,13252641,16590604,8521870,20000000
St. Trinian's,29830239,15000,29815239,,11400000
Double Take,29823162,29823162,00000,,24000000
Lean on Me,29823140,29823140,00000,,00000
Green Card,29804169,29804169,00000,,00000
Riding in Cars with Boys,29781453,29781453,00000,,47000000
Madeline,29767901,29767901,00000,,00000
A Perfect World,29747763,29747763,00000,,00000
Small Time Crooks,29739348,17071230,12668118,,18000000
Far from the Madding Crowd,29729450,12236500,17492950,,00000
Arthur and the War of Two Worlds,29729275,347136,29382139,,00000
Battlefield Earth: A Saga of the Year 3000,29725663,21471685,8253978,,80000000
Blank Check,29678400,29678400,00000,,00000
An Education,29652736,12574914,17077822,3343357,7500000
The Parent Trap,29650385,25150385,4500000,,00000
Taepung,29592720,139059,29453661,,00000
Una Moglie Bellissima,29589994,00000,29589994,,00000
"Tora, Tora, Tora",29548291,29548291,00000,,25000000
Angel Eyes,29544532,24044532,5500000,,38000000
Race 2,29476034,1579940,27896094,,00000
Twilight Zone: The Movie,29450919,29450919,00000,,10000000
Sinsegye,29448467,450222,28998245,,00000
Nothing in Common,29418104,29418104,00000,,00000
The Pledge,29406132,19719930,9686202,,45000000
The Evil Dead,29400000,2400000,27000000,,375000
Doraemon: Nobita to Midori no kyojinten,29397231,00000,29397231,,00000
Major Payne,29386820,29386820,00000,,00000
Pacific Heights,29381956,29381956,00000,,00000
Across the Universe,29367143,24343673,5023470,28076588,45000000
The Prince & Me,29356757,28165882,1190875,,30000000
Singh is Kinng,29339790,2523511,26816279,,00000
Ai,29338638,00000,29338638,,00000
Wa Pei,29338195,00000,29338195,,00000
Easy Money,29309766,29309766,00000,,00000
Guan yun chang,29307618,00000,29307618,,00000
Yeok-rin,29306967,00000,29306967,,00000
Meitantei Konan Zekkai no Puraib_to Ai,29302051,00000,29302051,,00000
Shoot to Kill,29300000,29300000,00000,,00000
Fools Rush In,29291566,29291566,00000,,00000
Wu Xia,29284214,11300,29272914,,00000
Quan Min Mu Ji,29260000,00000,29260000,,00000
Zindagi Na Milegi Dobara,29259272,3103656,26155616,,00000
Romy and Michele's High School Reunion,29230449,29230449,00000,,00000
The Stepfather,29227561,29062561,165000,12558265,20000000
The Road,29206732,8114270,21092462,8982516,25000000
Bulworth,29200533,26525834,2674699,,30000000
The Rose,29200000,29200000,00000,,8500000
Rang De Basanti,29197694,2197694,27000000,,5300000
Bugs!,29196944,19084280,10112664,,00000
Can't Buy Me Love,29118395,29118395,00000,,00000
The Object of my Affection,29106737,29106737,00000,,15000000
A Low Down Dirty Shame,29097256,29097256,00000,,10000000
Double Impact,29090445,29090445,00000,,16000000
Do-ga-ni,29056658,00000,29056658,,00000
3 Ninjas,29028000,29028000,00000,,00000
Far From Heaven,29027914,15901849,13126065,,13500000
Madonna: Truth or Dare,29012935,15012935,14000000,,00000
Wolf Creek,29005064,16186348,12818716,8952237,1100000
House Calls,29000000,29000000,00000,,00000
The Shaggy Dog,29000000,29000000,00000,,00000
The New Guy,28972187,28972187,00000,,13000000
The Life of David Gale,28920188,19694635,9225553,,50000000
The Upside of Anger,28915761,18761993,10153768,,12000000
Heist,28906817,23483357,5423460,,35000000
James and the Giant Peach,28900101,28900101,00000,,00000
The Guns of Navarone,28900000,28900000,00000,,00000
Mr. Magoo,28882456,21382456,7500000,,00000
In the Army Now,28881266,28881266,00000,,00000
The Player,28876702,21706101,7170601,,8000000
"Girl, Interrupted",28871190,28871190,00000,,24000000
Nuts,28866028,28866028,00000,,00000
Draft Day,28842237,28842237,00000,7583497,25000000
The Adventures of the Wilderness Family,28819175,28819175,00000,,00000
Samson and Delilah,28800000,28800000,00000,,00000
Ghosts of the Abyss,28780668,17093668,11687000,,00000
Case 39,28773827,13261851,15511976,4824578,27000000
Boiler Room,28773637,16963963,11809674,,9000000
Yu-Gi-Oh,28762690,19762690,9000000,,20000000
Baby Boy,28734552,28734552,00000,,16000000
Agent Cody Banks 2: Destination London,28703083,23514247,5188836,,26000000
Baramgwa hamjje sarajida,28686545,00000,28686545,,00000
Starman,28680432,28680432,00000,,00000
American Psycho,28651551,15047419,13604132,,8000000
Wrong Turn,28649556,15417771,13231785,,10000000
Carnal Knowledge,28623000,28623000,00000,,00000
Hoosiers,28607524,28607524,00000,,00000
Jodhaa Akbar,28594629,3444629,25150000,,00000
Final Analysis,28590665,28590665,00000,,00000
Singham,28581709,350864,28230845,,00000
W.,28575778,25534493,3041285,8291096,25100000
Nae Anaeui Modeun Geot,28555285,00000,28555285,,00000
The Out-of-Towners,28544120,28544120,00000,,40000000
Drop Zone,28523262,28523262,00000,,00000
Galapagos,28465917,19946586,8519331,,00000
L.A. Story,28463149,28463149,00000,,00000
Frost/Nixon,28452945,18622031,9830914,7018934,29000000
Cop and &frac12;,28417230,28417230,00000,,00000
High Road to China,28416459,28416459,00000,,00000
The Carpetbaggers,28409547,28409547,00000,,00000
"Dirty Mary, Crazy Larry",28401735,28401735,00000,,00000
Go!,28350471,16842303,11508168,,6500000
A Man for All Seasons,28350000,28350000,00000,,3900000
I Give It a Year,28328531,34657,28293874,73753,00000
Brown Sugar,28315272,27362712,952560,,8000000
Let Me In,28270399,12134935,16135464,7186902,20000000
Taxi Driver,28262574,28262574,00000,,1000000
The Shawshank Redemption,28233104,28233104,00000,,25000000
Thunderbirds,28231444,6768055,21463389,,55000000
The Cheap Detective,28221552,28221552,00000,,00000
Sin-ui Hansu,28211214,00000,28211214,15119,00000
Marathon Man,28204261,28204261,00000,,00000
Ernest Saves Christmas,28202109,28202109,00000,,00000
"20,000 Leagues Under the Sea",28200000,28200000,00000,,5000000
"Lock, Stock and Two Smoking Barrels",28172686,3714067,24458619,,1350000
Dirty Harry,28153434,28153434,00000,,00000
A Single Man,28142379,9176000,18966379,4482240,7000000
Huà Bì,28134879,00000,28134879,,00000
The Lazarus Effect,28101570,25801570,2300000,1884076,5000000
That Darn Cat!,28062222,28062222,00000,,00000
Police Academy 4: Citizens on Patrol,28061343,28061343,00000,,00000
Doogal,28058652,7578946,20479706,5559271,20000000
Pokemon 4Ever,28032301,1732301,26300000,,00000
Cirque du Soleil: Worlds Away,28012862,12512862,15500000,1658692,25000000
Slap Shot,28000000,28000000,00000,,00000
Herbie Goes to Monte Carlo,28000000,28000000,00000,,00000
Out to Sea,27974168,27974168,00000,,00000
The Brothers,27958191,27457409,500782,,6000000
The Hindenburg,27945225,27945225,00000,,00000
Appaloosa,27911453,20211394,7700059,11849281,20000000
Homefront,27901338,20158492,7742846,7889090,22000000
Hoffa,27893490,22867875,5025615,,35000000
Traitor,27882226,23530831,4351395,15112066,22000000
Manatsu no Houteishiki,27881203,00000,27881203,,00000
Friday,27878724,27409510,469214,,3500000
The Best of Me,27866213,26766213,1100000,8988100,26000000
Mrs. Henderson Presents,27836366,11036366,16800000,5824497,20000000
The Other Sister,27807627,27807627,00000,,00000
Playing for Keeps,27805632,13103272,14702360,2183108,00000
Uncommon Valor,27801480,27801480,00000,,00000
RocknRolla,27794339,5700626,22093713,8201611,18000000
Saving Grace,27786849,12178602,15608247,,4000000
Air Bud,27771629,24629916,3141713,,3000000
Cirque du Soleil - Journey of Man,27751781,15626076,12125705,,00000
Nurse Betty,27732366,25170054,2562312,,24000000
Menace II Society,27731527,27731527,00000,,3500000
Sou Sou,27721037,01037,27720000,,00000
Love and Basketball,27709625,27441122,268503,,15000000
Dark Skies,27704111,17418667,10285444,5050643,3500000
Rajneeti,27702802,1514557,26188245,,00000
The Island of Dr. Moreau,27663982,27663982,00000,,40000000
Internal Affairs,27661878,27661878,00000,,00000
Goal! The Dream Begins,27610873,4283255,23327618,12574388,33000000
Never Cry Wolf,27569673,27569673,00000,,00000
Bol Bachchan,27565784,1257892,26307892,,00000
Rear Window,27559601,27559601,00000,,00000
Teachers,27536746,27536746,00000,,00000
The Last Mimzy,27519694,21471047,6048647,21371289,00000
Self/Less,27516710,12279691,15237019,,26000000
Michael Collins,27511248,11030963,16480285,,25000000
The Thing,27501814,16928670,10573144,5183350,38000000
Tailor of Panama,27491653,13491653,14000000,,18000000
Bumchoiwaui junjaeng,27482633,00000,27482633,,00000
Mandela: Long Walk to Freedom,27480015,8323085,19156930,2022633,35000000
Ramona and Beezus,27469621,26167002,1302619,21361042,15000000
Samiy Luchshiy Film,27464635,00000,27464635,,00000
Ji Jie Hao,27455208,00000,27455208,,00000
Victory,27453000,10853000,16600000,,00000
Dune,27447471,27447471,00000,,45000000
To Die For,27420940,21016710,6404230,,20000000
Desperately Seeking Susan,27398584,27398584,00000,,00000
Daai mo seut si,27394383,00000,27394383,,00000
Memphis Belle,27385582,27385582,00000,,00000
Clerks II,27342246,24148068,3194178,27730181,5000000
Mr. Holmes,27307785,17737646,9570139,,00000
Cannonball Run II,27299433,27299433,00000,,00000
Burnt,27286403,13546332,13740071,,20000000
The Muppet Christmas Carol,27281507,27281507,00000,,12000000
Welcome,27280000,00000,27280000,,00000
Serpico,27274150,27274150,00000,,00000
Cadillac Man,27257086,27257086,00000,,00000
L'Ours,27254894,27254894,00000,,00000
Zwartboek,27238354,4398532,22839822,,22000000
A Passage to India,27187653,27187653,00000,,27500000
Dark City,27159564,14337579,12821985,,27000000
Baby Geniuses,27151490,27151490,00000,,13000000
Observe and Report,27148898,24007324,3141574,13905316,18000000
Mongol,27147349,5705761,21441588,3122891,18000000
The Pirate Fairy,27131768,00000,27131768,18068534,00000
The Jazz Singer,27118000,27118000,00000,,00000
Flash Gordon,27107960,27107960,00000,,35000000
The Story of Us,27100030,27100030,00000,,50000000
Fast Times at Ridgemont High,27092880,27092880,00000,,4500000
The Musketeer,27053815,27053815,00000,,40000000
The Big Hit,27052167,27052167,00000,,13000000
The Cave,27028028,14888028,12140000,,30000000
Monsoon Wedding,27025600,13876974,13148626,,1200000
Guarding Tess,27023278,27023278,00000,,00000
Legenda No. 17,27014935,00000,27014935,,00000
Paulie,27008669,27008669,00000,,00000
Relatos salvages,27007072,3107072,23900000,80712,00000
Un monstre à Paris ,27000381,00000,27000381,968677,40000000
The Outlaw Josey Wales,27000000,27000000,00000,,00000
The Lord of the Rings,27000000,27000000,00000,,00000
Now and Then,26988915,26988915,00000,,00000
Hors de Prix,26980663,2164670,24815993,,00000
Rendition,26939925,9736045,17203880,6081570,27500000
Tron,26918576,26918576,00000,,17000000
Spy Hard,26906039,26906039,00000,,18000000
You're Next,26887177,18494006,8393171,2731247,00000
Doraemon: Nobita's Great Adventure into the Underworld,26872950,00000,26872950,,00000
Splice,26857459,17010170,9847289,7004206,30000000
The Way Way Back,26853810,21502690,5351120,3507764,5000000
Jing mo fung wan: Chen Zhen,26822441,50433,26772008,,00000
Housefull 2,26816657,1586745,25229912,,00000
Shoot 'Em Up,26796824,12796824,14000000,15396525,00000
The Dream Team,26793650,26793650,00000,,00000
Species 2,26765560,19165560,7600000,,00000
Baahubali: The Beginning,26738000,6738000,20000000,,40000000
Sorority Row,26735797,11965282,14770515,3609048,12500000
Eye for an Eye,26729447,26729447,00000,,20000000
A Prairie Home Companion,26716191,20342852,6373339,8662528,10000000
Overboard,26713187,26713187,00000,,00000
Timeline,26703184,19480739,7222445,,80000000
Bride Wars,26692082,00000,26692082,,00000
Yattàman,26669089,00000,26669089,,00000
Event Horizon,26668092,26668092,00000,,60000000
Gekijyohan SPEC Ten,26633141,00000,26633141,,00000
Prizzi's Honor,26614323,26614323,00000,,00000
El Cid,26600000,26600000,00000,,00000
Glory,26593580,26593580,00000,,18000000
A Clockwork Orange,26589355,26589355,00000,,00000
Oliver Twist,26587287,1987287,24600000,,65000000
One True Thing,26580440,23209440,3371000,,30000000
The Texas Chainsaw Massacre,26572439,26572439,00000,,140000
Harriet the Spy,26539321,26539321,00000,,13000000
The Great Gatsby,26533200,26533200,00000,,7000000
Tim Burton's The Nightmare Before Christmas 3D,26532041,24732041,1800000,,00000
An American Werewolf in Paris,26521435,26521435,00000,,00000
Apollo 18,26517819,17686929,8830890,4494370,5000000
Gonggongui jeog 3,26497132,00000,26497132,,00000
Blast from the Past,26494611,26494611,00000,,35000000
First Kid,26459681,26459681,00000,,00000
Soul Man,26447273,26447273,00000,,00000
Upside Down,26387039,102118,26284921,1521996,00000
House Party,26385627,26385627,00000,,00000
The Night Before,26384111,25787526,596585,,00000
Kabhi Khushi Kabhie Gham,26372000,2862000,23510000,,00000
Conan the Destroyer,26365298,26365298,00000,,18000000
The Quiet American,26348203,12987647,13360556,,20000000
The Box,26341896,15051977,11289919,5696030,25000000
Bokura ga ita Zenpen,26324268,00000,26324268,,00000
The Whole Ten Yards,26323969,16323969,10000000,,30000000
Houseguest,26313748,26313748,00000,,00000
Deceived,26300329,26300329,00000,,00000
Sayonara,26300000,26300000,00000,,00000
Wildcats,26285544,26285544,00000,,00000
Necessary Roughness,26255594,26255594,00000,,00000
The Raven,26254942,16008272,10246670,3192262,26000000
I.Q.,26240779,26240779,00000,,00000
All Dogs Go To Heaven,26220877,26220877,00000,,00000
Dumb and Dumberer: When Harry Met Lloyd,26214846,26214846,00000,,30000000
My Life,26208505,26208505,00000,,00000
Blood Work,26199517,26199517,00000,,50000000
Protocol,26186631,26186631,00000,,00000
The New World,26184400,12712093,13472307,8206304,30000000
U2 3D,26170402,12898847,13271555,,15000000
"Couloirs du temps: Les visiteurs 2, Les",26146072,146072,26000000,,20000000
Jobs,26131410,16131410,10000000,104450,18000000
Your Highness,26121638,21596445,4525193,4873412,50000000
Fair Game,26097497,11497497,14600000,3045026,50000000
Micki + Maude,26080861,26080861,00000,,00000
Torrente 4 (3D),26079076,00000,26079076,,00000
Indigènes,26063572,320700,25742872,,18900000
The Elephant Man,26010864,26010864,00000,,5000000
Demetrius and the Gladiators,26000000,26000000,00000,,00000
Ocean Wonderland,26000000,00000,26000000,,00000
Son in Law,25989889,25989889,00000,,00000
Mighty Aphrodite,25985927,6387224,19598703,,00000
Extreme,25956958,12456958,13500000,,00000
Freaky Friday,25942000,25942000,00000,,00000
Ali G Indahouse,25936616,00000,25936616,,00000
The Cotton Club,25928721,25928721,00000,,48000000
Yeongashi,25927961,00000,25927961,,00000
Howards End,25919211,25919211,00000,,8000000
Amour,25915719,6738954,19176765,,9700000
"Yours, Mine and Ours",25912624,25912624,00000,,00000
Erinnerungen an die Zukunft,25900000,25900000,00000,,00000
Cry Freedom,25899797,5899797,20000000,,29000000
Cactus Flower,25889208,25889208,00000,,00000
Carrie,25878153,25878153,00000,,1800000
All About the Benjamins,25873145,25482931,390214,,14000000
Saving Silverman,25873142,19351569,6521573,,22000000
Our Idiot Brother,25861249,24814830,1046419,7933304,5000000
Rollerball,25852508,18990542,6861966,,70000000
Shadowlands,25842377,25842377,00000,,22000000
Murder at 1600,25826788,25826788,00000,,00000
Betrayed,25816139,25816139,00000,,00000
De rouille et d’os,25807134,2061449,23745685,,00000
Only When I Laugh,25782304,25782304,00000,,00000
Bratz,25747223,10010209,15737014,39449424,00000
Nobo no shiro,25746258,00000,25746258,,00000
Ice Princess,25732334,24381334,1351000,,25000000
From Dusk Till Dawn,25728961,25728961,00000,,20000000
Das Weisse Band: Eine deutsche Kindergeschichte,25727044,2222862,23504182,,18000000
Loaded Weapon 1,25726318,25726318,00000,,13000000
Big Miracle,25693998,20157300,5536698,9064195,40000000
The Wind That Shakes the Barley,25670174,1829142,23841032,,8300000
Kokowaah 2,25630168,00000,25630168,,00000
Agnes of God,25627836,25627836,00000,,00000
Jonah: A VeggieTales Movie,25608779,25571351,37428,,14000000
Down Periscope,25607849,25607849,00000,,00000
Peyton Place,25600000,25600000,00000,,00000
Company 9,25600000,00000,25600000,,00000
Jumpin' Jack Flash,25587804,25587804,00000,,00000
The Outsiders,25584680,25584680,00000,,10000000
Candyman,25554348,25554348,00000,,00000
Funny Farm,25537221,25537221,00000,,00000
The Muppets Take Manhattan,25534703,25534703,00000,,00000
Halloween II,25533818,25533818,00000,,2500000
Talaash,25522290,2706375,22815915,,00000
Top Five,25514848,25317379,197469,926793,12000000
A Tale of Mari and Three Puppies,25513520,00000,25513520,,00000
A Nightmare on Elm Street,25504513,25504513,00000,,1800000
Beauty and the Beast (IMAX),25487028,25487028,00000,,00000
Elle s'appelait Sarah,25480031,7691700,17788331,,14500000
My Father the Hero,25479558,25479558,00000,,00000
Mimic,25454187,25454187,00000,,00000
The Last Exorcism Part II,25448707,15179303,10269404,1463036,4000000
Billy Madison,25441250,25441250,00000,,00000
__ (Jik zin),25414221,00000,25414221,,00000
Tin Men,25411386,25411386,00000,,00000
Desperado,25405445,25405445,00000,,7000000
Persepolis,25397460,4443403,20954057,,7300000
In America,25382911,15539656,9843255,,00000
The Absent Minded Professor,25381407,25381407,00000,,00000
Women's Team Handball,25377585,00000,25377585,,00000
In Love and War,25357417,14466354,10891063,,00000
25th Hour,25344490,13084595,12259895,,4500000
Can't Hardly Wait,25339117,25339117,00000,,10000000
The Great Race,25333333,25333333,00000,,00000
The Last Legion,25332060,5932060,19400000,,67000000
Escape from L.A.,25329895,25329895,00000,,50000000
Heartburn,25314289,25314289,00000,,00000
Xi Yang Yang Yu Hui Tai Lang Zhi Kaixin Chuang Long Nian,25310000,00000,25310000,,00000
The Woman in Red,25308147,25308147,00000,,00000
Le prénom,25307405,61611,25245794,,11000000
Bride & Prejudice,25269040,6601079,18667961,,7000000
Irma La Douce,25246588,25246588,00000,,00000
Escape from New York,25244700,25244700,00000,,6000000
The Magdalene Sisters,25218042,4890878,20327164,,00000
Alien Nation,25216243,25216243,00000,,00000
Sophie's Choice,25215547,25215547,00000,,00000
Baby Boom,25207480,25207480,00000,,00000
Black Widow,25205460,25205460,00000,,00000
Grace of Monaco,25199891,00000,25199891,,30000000
Race,25195835,1367024,23828811,,00000
Fallen,25188006,25188006,00000,,00000
The Morning After,25147055,25147055,00000,,00000
Qiàn N_ Y_u Hún,25141990,00000,25141990,,00000
Don't Tell Mom the Babysitter's Dead,25122195,25122195,00000,,00000
The Master,25116740,16247159,8869581,1851994,37500000
Corky Romano,25116103,23978402,1137701,,11000000
Cursed,25114901,19294901,5820000,,35000000
Poetic Justice,25107237,25107237,00000,,14000000
Problem Child 2,25104700,25104700,00000,,00000
Against All Odds,25100000,25100000,00000,,00000
In the Name of the Father,25096862,25096862,00000,,00000
Midnight in the Garden of Good and Evil,25078937,25078937,00000,,35000000
The Wood,25059640,25059640,00000,,6000000
Wyatt Earp,25052000,25052000,00000,,63000000
Ivan Tsarevich i Seryy Volk,25047727,00000,25047727,,00000
Mad Money,25044057,20668843,4375214,14591691,22000000
Te shu shen fen,25040000,00000,25040000,1010240,00000
Ernest Goes to Jail,25029569,25029569,00000,,00000
The Exorcist III,25011739,25011739,00000,,00000
A Midsummer Night's Dream,25011645,16071990,8939655,,00000
Exorcist II: The Heretic,25011000,25011000,00000,,14000000
Thunderbolt and Lightfoot,25000000,25000000,00000,,00000
Logan's Run,25000000,25000000,00000,,7000000
Some Like it Hot,25000000,25000000,00000,,2883848
The Stewardesses,25000000,13500000,11500000,,200000
Little Man Tate,24989789,24989789,00000,,00000
Les Profs 2,24948589,00000,24948589,,00000
Invasion of the Body Snatchers,24946533,24946533,00000,,00000
Aloha,24935799,21052030,3883769,3402089,37000000
Fright Night,24922237,24922237,00000,,00000
Catch-22,24911670,24911670,00000,,18000000
Before the Devil Knows You're Dead,24909088,7085511,17823577,5522597,00000
Kurtlar vadisi - Irak,24906717,00000,24906717,,8300000
Recep Ivedik,24878340,00000,24878340,,00000
Navy SEALs,24824126,24824126,00000,,00000
Airplane II: The Sequel,24811386,24811386,00000,,00000
American Ultra,24801628,14439985,10361643,,00000
Tai Chi Zero,24790553,212094,24578459,,00000
Tees Maar Khan,24785571,1076266,23709305,,00000
De l'autre côté du périph,24782953,08689,24774264,,00000
Quiz Show,24775084,24775084,00000,,00000
Nebraska,24761360,17654912,7106448,4279746,12000000
The Man Without a Face,24760338,24760338,00000,,00000
Bushi no ichibun,24724488,60910,24663578,,00000
Gorillas in the Mist,24720479,24720479,00000,,00000
Lottery Ticket,24719879,24719879,00000,10422624,17000000
Seed of Chucky,24716190,17016190,7700000,,29000000
Biutiful,24687524,5101237,19586287,2347561,35000000
Operation Dumbo Drop,24670346,24670346,00000,,00000
Sparkle,24660323,24397469,262854,10773948,10000000
The Other Side of Midnight,24652021,24652021,00000,,00000
Mad Max 2: The Road Warrior,24600832,24600832,00000,,2000000
The Apartment,24600000,18600000,6000000,,3000000
Punch-Drunk Love,24591031,17791031,6800000,,25000000
Triumph in the Skies,24590000,00000,24590000,,00000
Joe Somebody,24515990,22770864,1745126,,38000000
schlussmacher,24500000,00000,24500000,,00000
In the Valley of Elah,24489150,6777741,17711409,3798941,23000000
Jesus Christ Superstar,24477615,24477615,00000,,00000
I Don't Know How She Does It,24474463,9659074,14815389,3522487,24000000
The Emerald Forest,24468550,24468550,00000,,00000
Notorious,24464742,24464742,00000,,2000000
Pina,24460758,3520458,20940300,,00000
Lucky Lady,24441725,24441725,00000,,00000
Jodaeiye Nader az Simin,24426169,7098492,17327677,,800000
The Shipping News,24405825,11405825,13000000,,35000000
Bou Chau Mai Sing,24405298,32053,24373245,,00000
Tsurugidake: Ten no Ki,24405079,00000,24405079,,00000
In the Heat of the Night,24379978,24379978,00000,,2000000
Vacancy,24363007,19063007,5300000,15674209,00000
Arlington Road,24362501,24362501,00000,,21500000
The Next Best Thing,24355762,14983572,9372190,,25000000
Huang Jin Da Jie An,24350000,00000,24350000,,00000
The In-Laws,24345659,20440627,3905032,,00000
Kambakkht Ishq,24310181,1445739,22864442,,00000
Moscow on the Hudson,24304590,24304590,00000,,00000
Do the Right Thing,24289231,24289231,00000,,6000000
Aku no Kyoten,24281346,00000,24281346,,00000
To the Fore,24280130,00000,24280130,,00000
Eiga Kaibutsu-kun,24266083,00000,24266083,,00000
Bronco Billy,24265659,24265659,00000,,00000
The Incredible Burt Wonderstone,24255957,22537881,1718076,3198293,32000000
Warrior,24215385,13657115,10558270,10735187,25000000
Dolores Claiborne,24205071,24205071,00000,,00000
Wanderlust,24159934,17288155,6871779,3693422,32500000
The Guru,24150550,3051221,21099329,,11000000
Anfea: The Answer,24136016,00000,24136016,,00000
Dead Presidents,24104295,24104295,00000,,00000
The Adventures of Huck Finn,24103594,24103594,00000,,6500000
Spring Break,24071666,24071666,00000,,00000
Ong-Bak,24062965,4563167,19499798,,00000
Damien: Omen II,24000000,24000000,00000,,00000
An Unmarried Woman,24000000,24000000,00000,,00000
Swimming Pool,23996679,10105505,13891174,,7800000
Mommie Dearest,23988509,17988509,6000000,,5000000
Virtuosity,23980766,23980766,00000,,30000000
Adrenaline Rush: The Science of Risk,23970431,16933791,7036640,,00000
The Alamo,23911362,22406362,1505000,,92000000
The Railway Man,23910210,4438438,19471772,356105,18000000
Graduation Day,23894000,23894000,00000,,250000
Life as a House,23889158,15652637,8236521,,18000000
The Flamingo Kid,23859382,23859382,00000,,00000
Bei Tou Zou De Wu Nian,23840000,00000,23840000,,00000
Tom and Huck,23837227,23837227,00000,,00000
Lissi und der wilde Kaiser,23828403,00000,23828403,,00000
Da Shang Hai,23824720,00000,23824720,,00000
Renaissance Man,23822558,23822558,00000,,40000000
Steve Jobs,23815464,17712643,6102821,,00000
House of Wax,23800000,23800000,00000,,658000
Beyond and Back,23800000,23800000,00000,,00000
Magic,23800000,23800000,00000,,00000
Striking Distance,23798623,23798623,00000,,00000
Dickie Roberts: Former Child Star,23734486,22734486,1000000,,17000000
OSS 117,23726439,303328,23423111,,00000
Jacob's Ladder,23717465,23717465,00000,,00000
Santa Claus,23717291,23717291,00000,,00000
Geonchukhakgaeron,23702782,00000,23702782,,00000
Good Burger,23700919,23700919,00000,,00000
Class Action,23695988,23695988,00000,,00000
In the Cut,23693646,4717455,18976191,,12000000
Network,23689877,23689877,00000,,3800000
Sixteen Candles,23686027,23686027,00000,,00000
The Owl and the Pussycat,23681338,23681338,00000,,00000
North Country,23676771,18324242,5352529,14466151,30000000
Armored,23661038,15988876,7672162,6290930,20000000
Love Aaj Kal,23657432,2430083,21227349,,00000
Russian Dolls,23654241,326095,23328146,,00000
Two of a Kind,23646952,23646952,00000,,00000
Eight Crazy Nights,23607202,23607202,00000,,00000
The Great Mouse Detective,23605534,23605534,00000,,00000
The Best Years of Our Lives,23600000,23600000,00000,,2100000
Baksoogundal,23593168,00000,23593168,,00000
My Blue Heaven,23591472,23591472,00000,,00000
Hustle & Flow,23590772,22201798,1388974,,2800000
How to Make an American Quilt,23586725,23586725,00000,,00000
Oscar,23562716,23562716,00000,,00000
The Invisible,23540266,20568319,2971947,14273029,00000
Ernest Goes to Camp,23509382,23509382,00000,,00000
Legend,23506237,15502112,8004125,,25000000
Body Heat,23496500,23496500,00000,,00000
Xiao Shi De Zi Dan,23490000,00000,23490000,,00000
Hoodlum,23489997,23489997,00000,,00000
Chinjeolhan geumjassi,23471871,211667,23260204,,4500000
Il y a longtemps que je t'aime,23456628,3169305,20287323,,00000
Hum Aapke Hain Kaun...!,23450000,00000,23450000,,00000
Moteki,23442024,00000,23442024,,00000
Henry & June,23411903,11011903,12400000,,00000
Caligula,23400000,23400000,00000,,00000
Du zhan,23396698,128195,23268503,42177,00000
Summer Rental,23396077,23396077,00000,,00000
Boys on the Side,23394062,23394062,00000,,00000
Kingdom Come,23393939,23247539,146400,,7000000
Raging Bull,23380203,23380203,00000,,18000000
Before Midnight,23376973,8110621,15266352,1854818,3000000
Antwone Fisher,23367586,21078145,2289441,,12500000
Reindeer Games,23360779,23360779,00000,,36000000
Hoodwinked Too: Hood vs. Evil,23353111,10143779,13209332,2751816,30000000
Soul Kitchen,23347469,276901,23070568,,4900000
Zambezia,23346219,00000,23346219,,20000000
Once,23338122,9439923,13898199,,150000
Circle of Friends,23333082,23333082,00000,,00000
Auntie Mame,23300000,23300000,00000,,00000
Operation Petticoat,23300000,23300000,00000,,00000
Les femmes du 6ème étage,23295831,733294,22562537,,00000
La misma luna,23271741,12590147,10681594,6685214,1700000
[Rec],23266821,00000,23266821,,2100000
Turkisch fur Anfanger,23256073,00000,23256073,,00000
Platinum Data,23255764,00000,23255764,,00000
Kuai Le Dao Jia,23210000,00000,23210000,,00000
Benny & Joon,23202734,23202734,00000,,00000
Seems Like Old Times,23200000,23200000,00000,,00000
Stay Alive,23187506,23086480,101026,13715457,20000000
Chinatown,23169837,23169837,00000,,00000
Joyeux Noël,23134075,1054361,22079714,,22000000
The Cutting Edge,23131735,23131735,00000,,00000
Iron Eagle,23066122,23066122,00000,,00000
Super Troopers,23046142,18492362,4553780,,1200000
The Program,23042200,23042200,00000,,00000
The Players Club,23031390,23031390,00000,,5000000
"I Love You, Phillip Morris",23014027,2037459,20976568,,13000000
Bulletproof Monk,23010607,23010607,00000,,52000000
Ghost Dad,23007150,23007150,00000,,00000
"Same Time, Next Year",23000000,23000000,00000,,00000
The Wanderers,23000000,5000000,18000000,,00000
Lewis & Clark: Great Journey West,23000000,00000,23000000,,00000
The Russia House,22998000,22998000,00000,,00000
Aquamarine,22977327,18595716,4381611,29859796,12000000
Domino,22969202,10169202,12800000,15730341,50000000
"Goodbye, Columbus",22939805,22939805,00000,,00000
La Vie d'Adèle – Chapitres 1 & 2,22937201,2450504,20486697,1924902,5250000
D3: The Mighty Ducks,22936273,22936273,00000,,00000
Ella Enchanted,22913677,22913677,00000,,35000000
The Ruins,22910563,17432844,5477719,15732198,25000000
Rounders,22905674,22905674,00000,,12000000
Crimes of the Heart,22905000,22905000,00000,,00000
Modern Problems,22886688,22886688,00000,,8000000
Baggage Claim,22885836,21569509,1316327,3961274,8500000
Lola rennt,22879194,7267324,15611870,,1750000
The Glass House,22861785,17951431,4910354,,22000000
Alatriste,22860477,00000,22860477,,28000000
Enough Said,22850872,17550872,5300000,2683300,8000000
Paris,22850194,1010194,21840000,,00000
Raising Arizona,22847000,22847000,00000,,00000
Beloved,22843047,22843047,00000,,53000000
A Perfect Getaway,22815460,15515460,7300000,5783201,14000000
Missing in Action,22812411,22812411,00000,,00000
Hitchcock,22808677,6008677,16800000,,00000
Dr. T and the Women,22796811,13065561,9731250,,00000
Frankie and Johnny,22773535,22773535,00000,,00000
The 33,22769989,11412501,11357488,,25000000
Xanadu,22762571,22762571,00000,,00000
Le Scaphandre et le Papillon,22754472,5990075,16764397,2770148,14000000
Rudy,22750363,22750363,00000,,00000
Young Adult,22750356,16311571,6438785,4070628,12000000
Polisse,22744132,176988,22567144,,8900000
Santa vs. The Snowman,22743688,10243688,12500000,,00000
Desu Noto 3: L: Change the World,22730665,00000,22730665,,00000
Raia Gemu Saisei,22713078,00000,22713078,,00000
Prelude to a Kiss,22697691,20006730,2690961,,00000
Prophecy,22673340,22673340,00000,,12000000
Thunderheart,22660758,22660758,00000,,00000
Pure Luck,22641969,22641969,00000,,00000
Seupai,22632953,00000,22632953,,00000
Guilty as Sin,22622537,22622537,00000,,00000
The People Under the Stairs,22600328,22600328,00000,,00000
The French Lieutenant's Woman,22600000,22600000,00000,,00000
Bullet to the Head,22597969,9489829,13108140,7558228,55000000
Trance,22594052,2322593,20271459,,16000000
Drive Me Crazy,22591451,17843379,4748072,,8000000
The World's Greatest Athlete,22583370,22583370,00000,,00000
"Lt. Robin Crusoe, U.S.N.",22565634,22565634,00000,,00000
Much Ado About Nothing,22549338,22549338,00000,,8000000
Lionheart,22545360,22545360,00000,,00000
My Tutor,22544918,22544918,00000,,00000
The Care Bears Movie,22529601,22529601,00000,,00000
Victor/Victoria,22524614,22524614,00000,,00000
Captain Ron,22518097,22518097,00000,,00000
Adaptation,22498520,22498520,00000,,18500000
The Warriors,22490000,22490000,00000,,00000
My Bodyguard,22482952,22482952,00000,,00000
Cassandra's Dream,22478138,973018,21505120,,00000
Winter's Tale,22468620,12600231,9868389,3391250,60000000
Disco,22437089,00000,22437089,,00000
Red Corner,22435165,22435165,00000,,00000
Black Lightning,22435112,00000,22435112,,00000
License to Drive,22434275,22434275,00000,,00000
City by the Sea,22433915,22433915,00000,,40000000
He Got Game,22398680,21554585,844095,,25000000
Two Can Play That Game,22391450,22235901,155549,,13000000
Blue Chips,22359041,22359041,00000,,00000
At First Sight,22326247,22326247,00000,,40000000
My Fellow Americans,22294341,22294341,00000,,21500000
The Lion in Winter,22276975,22276975,00000,,00000
Hamlet,22271473,20488197,1783276,,00000
For the Love of Benji,22257624,22257624,00000,,00000
Empire of the Sun,22238696,22238696,00000,,00000
Super Size Me,22233808,11529368,10704440,,65000
Norma Rae,22228000,22228000,00000,,00000
NASCAR: The IMAX Experience,22215235,21550235,665000,,00000
The Last Starfighter,22200789,22200789,00000,,00000
The Bermuda Triangle,22200000,22200000,00000,,00000
My Blueberry Nights,22198996,866778,21332218,,10000000
Bulletproof,22197420,21162420,1035000,,00000
Waitress,22187264,19067631,3119633,23250226,1500000
To Be and To Have,22183435,7610471,14572964,,00000
The Sword in the Stone,22182353,22182353,00000,,00000
A Nightmare On Elm Street: The Dream Child,22168359,22168359,00000,,6000000
The Marine,22165608,18844784,3320824,29729761,15000000
House,22144631,19444631,2700000,,00000
Three Kingdoms: Resurrection of the Dragon,22139590,00000,22139590,,20000000
Son of Flubber,22129412,22129412,00000,,00000
The Medallion,22108977,22108977,00000,,41000000
The Juror,22079985,22079985,00000,,44000000
Home for the Holidays,22074731,17424349,4650382,,20000000
Nosotros Los Nobles,22073311,19700,22053611,,00000
The Man with the Iron Fists,22018988,15634090,6384898,6855109,15000000
Don Juan DeMarco,22011141,22011141,00000,,25000000
In Search of Historic Jesus,22000000,22000000,00000,,00000
Death Wish,22000000,22000000,00000,,00000
The Big Parade,22000000,11000000,11000000,,245000
Meitantei Conan: Senritsu no furu sukoa,21997163,00000,21997163,,00000
Joy Ride,21973182,21973182,00000,,23000000
Unaccompanied Minors,21970831,16655224,5315607,7250962,25000000
Feichang Xingyun,21970000,00000,21970000,,8000000
Amy,21947878,8397920,13549958,,00000
Love Don't Cost a Thing,21937235,21897389,39846,,00000
Herutâ sukerutâ,21927919,00000,21927919,,00000
Partner,21916101,1062840,20853261,,00000
Beasts of the Southern Wild,21911774,12795746,9116028,7110894,1800000
Biker Boyz,21908034,21908034,00000,,00000
"Io, Loro e Lara",21903000,00000,21903000,,00000
Flicka,21896367,21000147,896220,51580674,15000000
Reno 911!: Miami,21851362,20342161,1509201,20347730,10000000
Just Wright,21851314,21524012,327302,10887206,12000000
Only the Lonely,21830957,21830957,00000,,00000
Mr. 3000,21827296,21800302,26994,,30000000
A Soldier's Story,21821347,21821347,00000,,00000
Melancholia,21817298,3030848,18786450,2576033,9400000
Il Postino,21812813,21812813,00000,,00000
The Caine Mutiny,21800000,21800000,00000,,00000
Fair*Game,21792905,9540691,12252214,,00000
Little Voice,21787233,4595000,17192233,,6000000
Little Black Book,21758371,20422207,1336164,,30000000
Exodus,21750000,21750000,00000,,4000000
Son of Sardaar,21747828,713754,21034074,,00000
Se Eu Fosse Voce 2,21734431,00000,21734431,,00000
Shining Through,21733781,21733781,00000,,00000
7 gwanggu,21729647,00000,21729647,,00000
Friday the 13th Part 2,21722776,21722776,00000,,1250000
Lock Up,21717616,21717616,00000,,00000
Leap of Faith,21715759,21715759,00000,,00000
Cousins,21707236,21707236,00000,,00000
The Green Berets,21707027,21707027,00000,,00000
"The Russians Are Coming, the Russians Are Coming",21693114,21693114,00000,,00000
Class,21667789,21667789,00000,,00000
White Oleander,21657770,16357770,5300000,,16000000
Como agua para chocolate,21656534,21656534,00000,,00000
The Rookie,21633874,21633874,00000,,00000
Doomsday,21621188,11008770,10612418,11008549,33000000
Wild Child,21618331,00000,21618331,,00000
The Quest,21607190,21607190,00000,,00000
Wicker Park,21601257,13001257,8600000,,30000000
Consenting Adults,21591728,21591728,00000,,00000
Over Her Dead Body,21589617,7563670,14025947,8501767,10000000
Black or White,21571189,21571189,00000,4014896,9000000
Love the Coopers,21550479,20862418,688061,,18000000
The Rum Diary,21544732,13109815,8434917,5099718,00000
Blackbeard's Ghost,21540050,21540050,00000,,00000
Man of the House,21518247,19118247,2400000,,50000000
Army of Darkness,21502976,11502976,10000000,,11000000
Desu Noto,21497802,00000,21497802,,00000
The Man Who Wasn't There,21494849,7494849,14000000,,00000
Married to the Mob,21486757,21486757,00000,,00000
Enter the Dragon,21483063,21483063,00000,,00000
Eiga doraemon: Shin. Nobita no uchû kaitakushi,21463266,00000,21463266,,00000
Tough Guys,21458229,21458229,00000,,00000
Toys,21452082,21452082,00000,,00000
Quigley Down Under,21413105,21413105,00000,,20000000
Our Family Wedding,21404886,20249621,1155265,6196457,14000000
A Very Brady Sequel,21397954,21397954,00000,,00000
Daensing Kwin,21387594,00000,21387594,,00000
Cold Creek Manor,21384035,21384035,00000,,00000
The Fog,21378361,21378361,00000,,1000000
Penelope,21375166,10011996,11363170,9584290,00000
The First Power,21365321,21365321,00000,,00000
Center Stage,21361109,17200925,4160184,,18000000
Waist Deep,21344312,21344312,00000,24778705,00000
Rhinestone,21333906,21333906,00000,,00000
The King and I,21300000,21300000,00000,,00000
The Bells of St. Mary's,21300000,21300000,00000,,00000
The Freshman,21289527,21289527,00000,,00000
The Black Cauldron,21288692,21288692,00000,,00000
The Apostle,21277770,20733485,544285,,5000000
Revenge of the Nerds II: Nerds in Paradise,21276124,21276124,00000,,00000
Buried,21270290,1044143,20226147,,1987650
Happy-Go-Lucky,21234179,3512016,17722163,,00000
Nazotoki Wa Dinner No Ato De,21216502,00000,21216502,,00000
New York Minute,21215882,14018364,7197518,,40000000
A Haunted House 2,21206861,17329487,3877374,2768418,4000000
Fame,21202829,21202829,00000,,00000
Straight Talk,21202099,21202099,00000,,00000
Mister Roberts,21200000,21200000,00000,,00000
The Guard,21197454,5359774,15837680,,6000000
The Right Stuff,21192102,21192102,00000,,27000000
Raising Cain,21171695,21171695,00000,,11000000
ATL,21170563,21170563,00000,29914453,17000000
A Nightmare On Elm Street Part 2: Freddy's Revenge,21163999,21163999,00000,,3000000
Cujo,21156152,21156152,00000,,00000
Coneheads,21153686,21153686,00000,,00000
A Stir of Echoes,21133087,21133087,00000,,12000000
The Divine Weapon,21122661,00000,21122661,,00000
"Oh God, You Devil!",21112090,21112090,00000,,00000
Ferngully… The Last Rainforest,21111825,21111825,00000,,00000
Top Secret!,21100000,21100000,00000,,00000
The Banquet,21094782,00000,21094782,,00000
Weekend Pass,21058033,21058033,00000,,00000
Punchline,21032000,21032000,00000,,00000
Christine,21017849,21017849,00000,,00000
Night Shift,21017056,21017056,00000,,00000
Pokemon Advanced Generation 2006,21011389,00000,21011389,,00000
Dracula,21000000,21000000,00000,,00000
The World's Greatest Lover,21000000,21000000,00000,,00000
Cat People,21000000,7000000,14000000,,12500000
High School High,20995023,20995023,00000,,00000
A Room with a View,20966644,20966644,00000,,3000000
La Guerre du feu,20959585,20959585,00000,,12500000
Very Bad Things,20947286,9801782,11145504,,10000000
Tales from the Crypt: Demon Knight,20943520,20943520,00000,,12000000
The Devil's Rejects,20940428,17044981,3895447,,7000000
Nosso Lar,20932364,00000,20932364,,00000
Red Dog,20927794,00000,20927794,,9100000
Khumba,20898221,00000,20898221,639630,15000000
Amores Perros,20883834,5383834,15500000,,2000000
Mr. Baseball,20883046,20883046,00000,,00000
Short Circuit 2,20882000,20882000,00000,,00000
The Hitcher,20855646,16379582,4476064,8880831,00000
Grand Prix,20845016,20845016,00000,,00000
Super Mario Bros.,20844907,20844907,00000,,42000000
Friends Mononoke-jima no Naki,20836650,00000,20836650,,00000
Georgia Rule,20819601,18882880,1936721,19512218,20000000
Irrational Man,20806471,4030360,16776111,,00000
Le Grand Chef,20794760,00000,20794760,,00000
The Postman,20783810,17593391,3190419,,80000000
The Air Up There,20782439,20782439,00000,,00000
Bu-reo-jin hwa-sal,20780134,00000,20780134,,00000
Boys and Girls,20773721,20773721,00000,,16000000
Left Behind,20769209,14019924,6749285,4011764,16000000
Hanbando,20766123,00000,20766123,,00000
Hotaru no Hikari,20753277,00000,20753277,,00000
Boys Don't Cry,20741000,11540607,9200393,,2000000
Alex Rider: Operation Stormbreaker,20722450,659210,20063240,,40000000
Eurotrip,20718223,17718223,3000000,,25000000
Best in Show,20695413,18621249,2074164,,6000000
Jason's Lyric,20680473,20680473,00000,,00000
Friday the 13th Part V: A New Beginning,20674880,20674880,00000,,2200000
Cat Ballou,20666667,20666667,00000,,00000
The Man From Snowy River,20659423,20659423,00000,,5000000
It Follows,20649774,14674077,5975697,1579642,2000000
Intersection,20643034,20643034,00000,,00000
Iron Will,20623071,20623071,00000,,00000
Dead Silence,20614661,16574590,4040071,17547220,00000
Walk Hard: The Dewey Cox Story,20606053,18317151,2288902,17754825,35000000
A Christmas Story,20605209,20605209,00000,,3250000
Country Strong,20601987,20218921,383066,11196030,15000000
You Are the Apple of My Eye,20600000,00000,20600000,,00000
Cocktail,20596759,1027121,19569638,,00000
Ricochet,20596333,20596333,00000,,00000
Bobby,20560906,11205901,9355005,14679021,14000000
Speechless,20548173,20548173,00000,,00000
The Last Castle,20541668,18208078,2333590,,60000000
Easy Virtue,20537741,2656784,17880957,,14000000
Fear,20528755,20528755,00000,,00000
Things Are Tough All Over,20516003,20516003,00000,,00000
The Last Picture Show,20505085,20505085,00000,,00000
Porky's Revenge,20500327,20500327,00000,,00000
The Final Conflict,20471000,20471000,00000,,00000
Chilgeup gongmuwon,20468524,00000,20468524,,00000
The Nutcracker in 3D,20466016,195459,20270557,,90000000
My Life in Ruins,20465206,8665206,11800000,9471635,17000000
The Groove Tube,20447000,20447000,00000,,00000
Margin Call,20433227,5353586,15079641,,3400000
Alien Adventure,20427678,5017383,15410295,,00000
The Adventures of Ford Fairlane,20423389,20423389,00000,,49000000
The Beach Girls,20418789,20418789,00000,,00000
Shame,20412841,4002293,16410548,,6500000
Some Kind of Hero,20400486,20400486,00000,,00000
Duel in the Sun,20400000,20400000,00000,,6000000
F/X,20395193,20395193,00000,,00000
F.I.S.T,20388920,20388920,00000,,11000000
Valentine,20384136,20384136,00000,,10000000
Code of Silence,20345361,20345361,00000,,00000
Delhi Belly,20289666,1532594,18757072,,00000
Kids,20269578,7269578,13000000,,1500000
The Incredible Shrinking Woman,20259000,20259000,00000,,00000
Action Jackson,20257000,20257000,00000,,7000000
The Namesake,20247501,13569248,6678253,9407607,8500000
Mobsters,20246790,20246790,00000,,00000
Vampires,20241395,20241395,00000,,20000000
Critical Condition,20240502,20240502,00000,,00000
City Hall,20231760,20231760,00000,,40000000
Six Pack,20225989,20225989,00000,,00000
An American Tail: Fievel Goes West,20218664,20218664,00000,,00000
Sudden Death,20214270,20214270,00000,,00000
Jag ar Nyfiken - en film i gult,20200000,20200000,00000,,00000
A Force of One,20200000,20200000,00000,,00000
Tarzan,20200000,00000,20200000,11769,00000
Die Fälscher,20195808,5484715,14711093,,6250000
The People vs. Larry Flynt,20191312,20191312,00000,,00000
Hodejegerne,20188740,1200010,18988730,,5250000
Beerfest,20159316,19185184,974132,28542646,17500000
Die Unendliche Geschichte,20158808,20158808,00000,,27000000
Juice,20146800,20146800,00000,,00000
Serving Sara,20146150,16930185,3215965,,29000000
Gekijoban Kamen Raida Ozu Wandafuru: Shogun to Niju-ichi no Koa Medaru/Kaizoku Sentai Gokaija Za Mubi Sora Tobu Yureisen,20145961,00000,20145961,,00000
Love and Death,20123742,20123742,00000,,3000000
Nanjing! Nanjing!,20122558,122558,20000000,,12000000
Legends of Oz: Dorothy’s Return,20107933,8462347,11645586,1354974,70000000
Another Stakeout,20107504,20107504,00000,,00000
Multiplicity,20101861,20101861,00000,,45000000
Tess,20093330,20093330,00000,,00000
Reign Over Me,20081987,19661987,420000,16404812,20000000
Reality Bites,20079850,20079850,00000,,00000
Kon-Tiki,20078585,1517410,18561175,,00000
Booty Call,20060051,20060051,00000,,00000
Blindness,20052958,3073392,16979566,,25000000
Saawariya,20052456,885574,19166882,,00000
With Honors,20043254,20043254,00000,,00000
Say Anything…,20036737,20036737,00000,,00000
Creepshow,20036244,20036244,00000,,8000000
The Presidio,20036000,20036000,00000,,00000
Down to You,20035310,20035310,00000,,9000000
I Heart Huckabees,20034713,12784713,7250000,,22000000
Tai Chi Hero,20016042,30830,19985212,,00000
The Life of Brian,20008693,20008693,00000,,4000000
Another Year,20005613,3205706,16799907,,8000000
Shane,20000000,20000000,00000,,00000
Outland,20000000,20000000,00000,,00000
Breaking Away,20000000,20000000,00000,,00000
The Great Waldo Pepper,20000000,20000000,00000,,00000
The Adventure of Sherlock Holmes' Smarter Brother,20000000,20000000,00000,,00000
Barry Lyndon,20000000,20000000,00000,,11000000
The Kentucky Fried Movie,20000000,15000000,5000000,,600000
Ho Voglia Di Te,20000000,00000,20000000,,00000
Barefoot in the Park,19994515,19994515,00000,,00000
Soshite chichi ni naru,19978023,333678,19644345,,00000
Rubbeldiekatz,19954186,00000,19954186,,00000
Frailty,19947280,13110448,6836832,,11000000
crazy/beautiful,19929123,16929123,3000000,,13000000
Unfaithfully Yours,19928200,19928200,00000,,00000
Un Prophète,19910624,2087720,17822904,,13000000
Breathless,19910002,19910002,00000,,00000
Suffragette,19904809,4124954,15779855,,00000
Fled,19892205,17192205,2700000,,30000000
Caché,19891331,3647381,16243950,,8000000
Volunteers,19875740,19875740,00000,,00000
Get Over It,19860259,11560259,8300000,,10000000
Altered States,19853892,19853892,00000,,00000
F/X2,19852153,19852153,00000,,00000
Child's Play 3,19850380,14250380,5600000,,00000
Melinda and Melinda,19826280,3826280,16000000,,00000
Hard Rain,19819494,19819494,00000,,70000000
Innerspace,19816619,19816619,00000,,00000
Un gallo con muchos huevos,19815164,9080818,10734346,,00000
Buena Vista Social Club,19809190,6997620,12811570,,00000
Cruising,19784223,19784223,00000,,00000
Color of Night,19750470,19750470,00000,,00000
Betsy's Wedding,19740070,19740070,00000,,00000
Gone Fishin',19736932,19736932,00000,,00000
The Cowboy Way,19731505,19731505,00000,,00000
Lady Sings the Blues,19726490,19726490,00000,,00000
Fire in the Sky,19724334,19724334,00000,,00000
Amelia,19722990,14246488,5476502,6973067,40000000
Summer Catch,19693891,19693891,00000,,17000000
Youth in Revolt,19685588,15285588,4400000,5941619,18000000
Prêt-à-Porter,19683073,11177058,8506015,,00000
Don't Be a Menace to South Central While Drinking Your Juice in the Hood,19674813,19674813,00000,,00000
Shackleton's Antarctic Adventure,19667161,15553324,4113837,,00000
Tucker: The Man and His Dream,19652638,19652638,00000,,00000
Neuilly Sa Mère,19637575,00000,19637575,,00000
Kuffs,19618135,19618135,00000,,00000
Go-ji-jeon,19603449,00000,19603449,,00000
Nighthawks,19600000,14600000,5000000,,5000000
The Serpent and the Rainbow,19595000,19595000,00000,,00000
8 Seconds,19582455,19582455,00000,,00000
Heavy Metal,19571091,19571091,00000,,9300000
Vampire in Brooklyn,19556475,19556475,00000,,14000000
Jetsons: The Movie,19543985,19543985,00000,,00000
The Professionals,19537346,19537346,00000,,00000
View from the Top,19526014,15614000,3912014,,00000
Police Academy 5: Assignment: Miami Beach,19510000,19510000,00000,,00000
This is the Army,19500000,19500000,00000,,00000
"Dolce Vita, La",19500000,19500000,00000,,00000
It Takes Two,19474589,19474589,00000,,00000
Blackhat,19472469,7889395,11583074,1403734,70000000
The Babe,19464550,17064550,2400000,,00000
"Corrina, Corrina",19452694,19452694,00000,,00000
Andarushia: Megami No Houfuku,19446029,00000,19446029,,00000
The Fly II,19441528,19441528,00000,,00000
House Party 2,19438638,19438638,00000,,5000000
Stella,19431069,19431069,00000,,00000
Guan lan,19428291,00000,19428291,,00000
Doug's 1st Movie,19421271,19421271,00000,,5000000
Get Carter,19417182,14967182,4450000,,40000000
An Innocent Man,19397847,19397847,00000,,00000
The Human Stain,19379387,5381227,13998160,,00000
Dad,19345975,19345975,00000,,00000
Tuck Everlasting,19344615,19161999,182616,,15000000
Deep Blue,19332261,132261,19200000,,00000
71: Into the Fire,19321681,159335,19162346,,00000
Joe,19319254,19319254,00000,,00000
Rock Star,19317765,16991902,2325863,,38000000
Le renard et l'enfant,19317689,00000,19317689,,00000
Only You,19315506,19315506,00000,,00000
Little Giants,19299064,19299064,00000,,00000
Posse,19290000,18290000,1000000,,00000
Summer of Sam,19288130,19288130,00000,,22000000
The Dead Zone,19287938,19287938,00000,,10000000
02046,19287484,1442337,17845147,,12000000
Bandidas,19282590,00000,19282590,8211520,35000000
The Perfect Man,19247775,16247775,3000000,,10000000
Half Past Dead,19233280,15567860,3665420,,25000000
Kwik,19225149,00000,19225149,,00000
The Principal,19214194,19214194,00000,,00000
Deathtrap,19201885,19201885,00000,,00000
House Party 3,19194572,19194572,00000,,00000
Martin Lawrence Live: RunTelDat,19184820,19184820,00000,,3000000
Auf der anderen Seite,19184629,742349,18442280,,00000
The Visitor,19174817,9427026,9747791,,4000000
Friday the 13th Part VII: The New Blood,19170001,19170001,00000,,2800000
Ladies in Lavender,19168295,6759422,12408873,,00000
The Fox,19146711,19146711,00000,,00000
Detective Conan: Jolly Roger in Deep Azure,19139455,00000,19139455,,00000
Vanity Fair,19123851,16123851,3000000,,23000000
Capitalism: A Love Story,19121531,14363397,4758134,4349439,20000000
Mother,19119165,19119165,00000,,00000
That's Entertainment,19100000,19100000,00000,,00000
Rushmore,19071269,17096053,1975216,,10000000
Blaze,19049727,19049727,00000,,00000
North Dallas Forty,19010710,19010710,00000,,00000
Johnny Mnemonic,19006201,19006201,00000,,00000
The Octagon,19000000,19000000,00000,,00000
The Boys from Brazil,19000000,19000000,00000,,12000000
The Jolson Story,19000000,19000000,00000,,00000
The Seduction of Joe Tynan,19000000,19000000,00000,,00000
Sniper,18994653,18994653,00000,,00000
The World's Fastest Indian,18991288,5128124,13863164,7288197,25000000
En kongelig affære,18983277,1546761,17436516,,00000
Bed of Roses,18972237,18972237,00000,,00000
The Replacement Killers,18967571,18967571,00000,,30000000
Akeelah and the Bee,18959424,18848430,110994,25846100,8000000
A Mighty Heart,18935657,9176787,9758870,5524956,15000000
To the Arctic 3D,18919397,14397723,4521674,,00000
Dead Man Down,18903193,10895295,8007898,4876100,30000000
The Eyes of Laura Mars,18900000,18900000,00000,,00000
Untamed Heart,18899204,18899204,00000,,00000
The Odd Couple II,18878566,18878566,00000,,00000
The Seventh Sign,18875011,18875011,00000,,00000
Mine Vaganti,18872126,00000,18872126,,9100000
Alfie,18871300,18871300,00000,,00000
Whip It,18856151,13043363,5812788,8068905,15000000
Kazaam,18843825,18843825,00000,,00000
Paternity,18838000,18838000,00000,,00000
See No Evil,18828036,15032800,3795236,45620494,8000000
Under the Rainbow,18826490,18826490,00000,,20000000
"What's New, Pussycat",18820000,18820000,00000,,00000
El Nino,18800245,00245,18800000,,00000
Macon County Line,18800000,18800000,00000,,00000
Across the Great Divide,18800000,18800000,00000,,00000
The Rebound,18774608,00000,18774608,,00000
The Merchant of Venice,18765585,3765585,15000000,,30000000
The Believers,18753438,18753438,00000,,00000
Pillow Talk,18750000,18750000,00000,,00000
Madhouse,18743686,18743686,00000,,00000
Admission,18733666,18007317,726349,2565902,13000000
Housefull,18726300,1183658,17542642,,10100000
"Grande, grosso e Verdone",18725496,00000,18725496,,00000
3000 Miles to Graceland,18708848,15738632,2970216,,62000000
Hello Again,18706554,18706554,00000,,00000
Waiting...,18673274,16124543,2548731,37949609,1125000
Anywhere But Here,18653615,18653615,00000,,23000000
Michael Jordan to the MAX,18642318,18642318,00000,,7000000
Paradise,18634643,18634643,00000,,00000
Fired Up,18608570,17231291,1377279,10406603,20000000
The Boatniks,18607492,18607492,00000,,00000
OMG: Oh My God,18602281,00000,18602281,,00000
I Am Curious,18570318,18570318,00000,,00000
Detroit Metal City,18569470,00000,18569470,,00000
Flight of the Navigator,18564613,18564613,00000,,00000
Blame it on Rio,18561998,18561998,00000,,00000
Year of the Dragon,18555050,18555050,00000,,00000
Some Kind of Wonderful,18553948,18553948,00000,,00000
Suspect,18549440,18549440,00000,,00000
The Quick and the Dead,18543650,18543650,00000,,32000000
An Unfinished Life,18535575,8535575,10000000,21477595,30000000
Project X,18532286,18532286,00000,,00000
[Rec] 2,18527766,27766,18500000,,5600000
De-Lovely,18524496,13337299,5187197,,15000000
Winx Club - Il Segreto Del Regno Perduto,18523991,00000,18523991,,00000
Paco to Maho no Ehon,18508052,00000,18508052,,00000
A Mighty Wind,18504539,17583468,921071,,6000000
El Clan,18504398,00000,18504398,,00000
Secret in Their Eyes,18500142,14703109,3797033,,20000000
The Curse of the Jade Scorpion,18496522,7496522,11000000,,26000000
Empire,18495444,17504595,990849,,3500000
Singles,18471850,18471850,00000,,00000
Casualties of War,18468714,18468714,00000,,00000
A Thousand Words,18450127,18450127,00000,4347898,40000000
Taking Care of Business,18438088,18438088,00000,,00000
Hey Baby,18429951,1411065,17018886,,00000
In Search of Castaways,18415385,18415385,00000,,00000
The Fan,18406215,18406215,00000,,55000000
Desert Flower,18405284,44348,18360936,,00000
Sabotage,18376443,10508518,7867925,4209135,35000000
Best Defense,18361590,18361590,00000,,00000
Dorian Gray,18353669,00000,18353669,,00000
Rockstar,18346912,985912,17361000,,00000
Sleeper,18344729,18344729,00000,,2000000
Cutthroat Island,18333397,9833397,8500000,,92000000
Simon Birch,18309860,18252684,57176,,20000000
Jagten,18309793,687185,17622608,518756,3450000
Good Guys Wear Black,18300000,18300000,00000,,00000
Machete Kills,18273009,8008161,10264848,3058678,20000000
Love Affair,18266245,18266245,00000,,00000
Sadako 3D,18261319,00000,18261319,,00000
Eye of the Beholder,18260865,16500786,1760079,,15000000
Crimes and Misdemeanors,18254702,18254702,00000,,00000
Loser,18250106,15464026,2786080,,20000000
Ladyhawke,18248879,18248879,00000,,20000000
That Darn Cat,18239932,18239932,00000,,00000
Harold & Kumar Go to White Castle,18225165,18225165,00000,,9000000
Sugar Hill,18219465,18219465,00000,,10000000
Daddy Day Camp,18209872,13235267,4974605,5473206,6000000
Cocoon: The Return,18204039,18204039,00000,,00000
Dead Men Don't Wear Plaid,18196170,18196170,00000,,00000
Getting Even With Dad,18195538,18195538,00000,,00000
Bears,18151746,17780194,371552,,00000
Skin Deep,18146373,18146373,00000,,00000
The Sure Thing,18135531,18135531,00000,,00000
All the Pretty Horses,18120267,15527125,2593142,,45000000
Dope,18115484,17506470,609014,407585,7000000
Keeping Mum,18114037,1619466,16494571,,00000
Friends with Money,18110152,13368437,4741715,9775698,6500000
Young Sherlock Holmes,18106539,18106539,00000,,18000000
Gone,18100189,11682205,6417984,3094752,00000
Last Man Standing,18100017,18100017,00000,,67000000
Five Easy Pieces,18099091,18099091,00000,,00000
DuckTales: The Movie - Treasure of the Lost Lamp,18075331,18075331,00000,,00000
Private Lessons,18064851,18064851,00000,,00000
Repo Men,18048066,13794835,4253231,8532129,32000000
Milk Money,18041044,18041044,00000,,00000
Everything You Always Wanted to Know,18016290,18016290,00000,,2000000
Windwalker,18000000,18000000,00000,,00000
Ice Castles,18000000,18000000,00000,,00000
Hardly Working,18000000,18000000,00000,,00000
Ann och Eve - de Erotiska,18000000,18000000,00000,,00000
Death on the Nile,18000000,18000000,00000,,00000
The Private Eyes,18000000,18000000,00000,,00000
"Ensemble, c'est tout",17988919,00000,17988919,,00000
The Howling,17985000,17985000,00000,,1000000
Wes Craven's New Nightmare,17976855,17976855,00000,,8000000
Used People,17957265,17957265,00000,,00000
Bokura ga Ita Kohen,17953383,00000,17953383,,00000
The Pom Pom Girls,17900000,17900000,00000,,00000
Delhi 6,17884197,879913,17004284,,00000
African Cats,17883747,15428747,2455000,,00000
The Crow: City of Angels,17883659,17883659,00000,,00000
Bedknobs and Broomsticks,17871174,17871174,00000,,00000
Antitrust,17865209,10965209,6900000,,30000000
Brothers,17856688,656688,17200000,,13000000
Sibling Rivalry,17854933,17854933,00000,,00000
Friday the 13th Part VI: Jason Lives,17834917,17834917,00000,,3000000
City of Ember,17830244,7871693,9958551,7123017,38000000
Mortal Thoughts,17823327,17823327,00000,,00000
Honeysuckle Rose,17815212,17815212,00000,,00000
The Boston Strangler,17810894,17810894,00000,,00000
School for Scoundrels,17807569,17807569,00000,20760491,20000000
The Contender,17804273,17804273,00000,,9000000
For Whom the Bell Tolls,17800000,17800000,00000,,00000
Gaku: Minna no Yama,17772865,00000,17772865,,00000
Born Yesterday,17760754,17760754,00000,,00000
The Rage: Carrie 2,17757087,17757087,00000,,21000000
The Big Green,17736619,17736619,00000,,00000
Sarkar Raj,17722998,1009065,16713933,,00000
The Oxford Murders,17704131,04803,17699328,,10000000
The Betsy,17700000,17700000,00000,,00000
High Security Vacations,17686092,00000,17686092,,00000
For the Boys,17684580,17684580,00000,,00000
Vacations,17679082,00000,17679082,,00000
Heavy Weights,17662142,17662142,00000,,00000
Kit Kittredge: An American Girl,17657973,17657973,00000,17594946,10000000
Unfair: The Movie,17657692,00000,17657692,,00000
That Touch of Mink,17648927,17648927,00000,,00000
Scusa ma ti chiamo amore,17646235,00000,17646235,,00000
CB4,17642060,17642060,00000,,00000
Frantic,17637000,17637000,00000,,00000
The Accidental Detective,17624124,00000,17624124,,00000
Max Dugan Returns,17613720,17613720,00000,,00000
Alice Doesn't Live Here Anymore,17600000,17600000,00000,,00000
Swing Vote,17589867,16289867,1300000,7502365,21000000
Eye of the Needle,17583000,17583000,00000,,00000
Deliver Us From Eva,17573594,17573594,00000,,00000
Cat on a Hot Tin Roof,17570324,17570324,00000,,3000000
Take This Job and Shove It,17569000,17569000,00000,,00000
Jûsan-nin no shikaku,17555141,802778,16752363,2292130,00000
Adventureland,17553055,16044025,1509030,10722378,9800000
Wait Until Dark,17550741,17550741,00000,,00000
Hot Dog… The Movie,17540166,17540166,00000,,00000
Invasion U.S.A.,17536256,17536256,00000,,10000000
Lassiter,17513452,17513452,00000,,00000
Ocho apellidos catalanes,17500548,00000,17500548,,00000
Johnny Be Good,17500399,17500399,00000,,00000
Addicted,17499242,17390770,108472,3239055,5000000
Rebound,17492014,16809014,683000,,45000000
Beneath the Planet of the Apes,17489009,17489009,00000,,3000000
Angel,17488564,17488564,00000,,00000
White Palace,17487531,17487531,00000,,00000
Rachel Getting Married,17475475,12796861,4678614,6927904,12000000
Ragtime,17468158,17468158,00000,,00000
Glee: The 3D Concert Movie,17462398,11862398,5600000,,9000000
My Favorite Year,17458105,17458105,00000,,00000
Tristan & Isolde,17455613,14734633,2720980,14176022,00000
Above the Law,17450660,17450660,00000,,00000
Roll Bounce,17433072,17380866,52206,,10000000
A Guy Thing,17430594,15543862,1886732,,20000000
Disturbing Behavior,17411331,17411331,00000,,15000000
Gegege No Kitarô,17369625,00000,17369625,,00000
Extreme Measures,17369541,17369541,00000,,38000000
And So It Goes,17360801,15160801,2200000,578585,18000000
Born in East L.A.,17355263,17355263,00000,,00000
"Jo Jo Dancer, Your Life is Calling",17337232,17337232,00000,,00000
Sunshine Cleaning,17329337,12062558,5266779,5446149,5000000
My Baby's Daddy,17322212,17321573,00639,,12000000
12 Rounds,17306648,12234694,5071954,9077332,20000000
The Matador,17300838,12589255,4711583,8933839,10000000
Murder in the First,17300238,17300238,00000,,00000
Max Keeble's Big Move,17292381,17292381,00000,,12000000
Half Baked,17278980,17278980,00000,,8000000
Shenandoah,17268889,17268889,00000,,00000
Dolphins and Whales Tribes of the Ocean 3D,17252287,7714996,9537291,,6000000
A Bronx Tale,17239789,17239789,00000,,00000
Annapolis,17224992,17127992,97000,29928303,00000
The Phantom,17220599,17220599,00000,,45000000
Bright Star,17220091,4444637,12775454,,8500000
The Mission,17218000,17218000,00000,,00000
Hit & Run,17216955,13749300,3467655,3392814,22000000
No Escape,17213233,15339030,1874203,,00000
Her Alibi,17195050,17195050,00000,,00000
Angel Heart,17185000,17185000,00000,,00000
Sidekicks,17180393,17180393,00000,,00000
That Old Feeling,17168110,16337426,830684,,00000
Kites,17155193,1685269,15469924,,9200000
Election,17138828,14879556,2259272,,8500000
The Falcon and the Snowman,17130087,17130087,00000,,00000
Johnny Dangerously,17124395,17124395,00000,,00000
The NeverEnding Story II: The Next Chapter,17116963,17116963,00000,,00000
Von Ryan's Express,17111111,17111111,00000,,00000
The Valachi Papers,17106087,17106087,00000,,00000
Les Triplettes de Belleville,17100523,6998643,10101880,,2000000
Pet Sematary II,17092453,17092453,00000,,00000
Firehouse Dog,17087933,13922019,3165914,17245166,00000
Kung Pow: Enter the Fist,17033556,16033556,1000000,,10000000
Pandorum,17033431,10330853,6702578,5999568,40000000
Freejack,17033142,17033142,00000,,00000
Judy Moody and the Not Bummer Summer,17029882,15013650,2016232,3685831,00000
Somewhere,17023121,1785645,15237476,,7000000
Central do Brasil,17006158,5969553,11036605,,2900000
The Delta Force,17005599,17005599,00000,,00000
Diabolique,17003203,17003203,00000,,00000
Everyone's Hero,17000437,14523101,2477336,9836505,00000
Herbie Goes Bananas,17000000,17000000,00000,,00000
For Keeps?,17000000,17000000,00000,,00000
Kingdom of the Spiders,17000000,17000000,00000,,500000
Which Way Is Up?,17000000,17000000,00000,,00000
W.W. and the Dixie Dancekings,17000000,17000000,00000,,00000
The Country Bears,16988996,16988996,00000,,20000000
Island of Lemurs: Madagascar,16983677,16753988,229689,,00000
Win a Date with Tad Hamilton!,16980098,16980098,00000,,24000000
Catch That Kid,16959614,16703799,255815,,18000000
"House of 1,000 Corpses",16954014,12583510,4370504,,7000000
Lover Come Back,16937969,16937969,00000,,00000
Fruitvale Station,16928069,16098998,829071,4235952,900000
All the Right Moves,16927805,16927805,00000,,00000
Jury Duty,16927407,16927407,00000,,00000
Godsend,16910708,14334645,2576063,,30000000
Death Sentence,16907831,9534258,7373573,7668436,20000000
Looking for Mr. Goodbar,16900000,16900000,00000,,00000
Sounder,16889761,16889761,00000,,00000
Sugar and Spice,16880799,13276953,3603846,,00000
Georgy Girl,16873162,16873162,00000,,00000
Jaane Tu Ya Jaane Na,16869504,600922,16268582,,00000
Rabbit-Proof Fence,16866928,6199600,10667328,,7000000
Geronimo: An American Legend,16857966,16857966,00000,,00000
Le hérisson,16835188,828801,16006387,,00000
"Kiss Kiss, Bang Bang",16829464,4235837,12593627,6914060,15000000
Hollywoodland,16826251,14426251,2400000,8909990,00000
Lightning Jack,16821273,16821273,00000,,00000
A Touch of Class,16800000,16800000,00000,,00000
Valley Girl,16797122,16797122,00000,,00000
Femme Fatale,16792103,6592103,10200000,,35000000
Andre,16774699,16774699,00000,,00000
Monkey Kingdom,16747910,16432322,315588,,00000
My Soul to Take,16727470,14744435,1983035,5024958,25000000
Battle of the Year,16723377,8888355,7835022,275560,20000000
Kurôzu zero,16699857,00000,16699857,,00000
Blink,16668552,16668552,00000,,00000
Tremors,16667084,16667084,00000,,10000000
7-gwang-goo,16665595,00000,16665595,,00000
Rough Cut,16656125,16656125,00000,,00000
Emperor,16653511,16653511,00000,1879373,00000
The Hunter,16647800,16647800,00000,,00000
The Fabulous Baker Boys,16644211,16644211,00000,,00000
Bringing Out The Dead,16640210,16640210,00000,,32000000
Deep Cover,16639799,16639799,00000,,00000
True Crime,16635339,16635339,00000,,00000
Halloween 4: The Return of Michael Myers,16634499,16634499,00000,,5000000
Digimon: The Movie,16628751,9628751,7000000,,5000000
Paparazzi,16612072,15712072,900000,,20000000
Silent House,16610760,12739737,3871023,2821218,2000000
Reservation Road,16601440,101440,16500000,2621181,00000
Beat Street,16595791,16595791,00000,,00000
The Good Girl,16585503,14018296,2567207,,8000000
Baby's Day Out,16581575,16581575,00000,,50000000
00054,16574731,16574731,00000,,13000000
To Live and Die in L.A.,16570320,16570320,00000,,00000
Blue Valentine,16566240,9737892,6828348,4169658,1000000
Mindhunters,16566235,4476235,12090000,,27000000
My Girl 2,16559100,16559100,00000,,00000
Shocker,16554699,16554699,00000,,00000
Transamerica,16553163,9015303,7537860,3941119,1000000
National Lampoon's Class Reunion,16550727,16550727,00000,,00000
The Life and Times of Judge Roy Bean,16530578,16530578,00000,,00000
Miracle on 1st Street,16529062,00000,16529062,,00000
The Frighteners,16524115,16524115,00000,,00000
Original Sin,16521410,16521410,00000,,26000000
Krull,16519460,16519460,00000,,00000
Sea Rex 3D: Journey to a Prehistoric World,16515203,6096582,10418621,,5000000
Belle,16511348,10726630,5784718,,00000
Der Baader Meinhof Komplex,16498827,476270,16022557,,19700000
The War,16480770,16480770,00000,,00000
Heart and Souls,16479685,16479685,00000,,00000
Spacehunter: Adventures in the Forbidden Zone,16478265,16478265,00000,,00000
Terminal Velocity,16455799,16455799,00000,,00000
Jason X,16440974,12610731,3830243,,14000000
The Powerpuff Girls,16425701,11411644,5014057,,25000000
Candy,16408286,16408286,00000,,00000
A Change of Seasons,16400000,16400000,00000,,00000
Sergeant York,16400000,16400000,00000,,00000
Die Wilden Kerle 4,16400000,00000,16400000,,00000
"I Love You, Beth Cooper",16382538,14800725,1581813,10485219,18000000
The Words,16369708,11494838,4874870,,6000000
Hudson Hawk,16355667,16355667,00000,,65000000
American Dreamz,16353669,7156725,9196944,,17000000
The Big Easy,16351403,16351403,00000,,00000
Two Lovers,16349034,3149034,13200000,,12000000
Monkey Trouble,16344520,16344520,00000,,00000
Burglar,16337355,16337355,00000,,00000
MacArthur,16320000,16320000,00000,,00000
The Silencers,16318124,16318124,00000,,00000
Masters of the Universe,16316460,16316460,00000,,00000
Weird Science,16316258,16316258,00000,,00000
A Simple Plan,16311763,16311763,00000,,17000000
Muppets From Space,16304786,16304786,00000,,24000000
Going My Way,16300000,16300000,00000,,00000
Howard the Duck,16295774,16295774,00000,2433580,30000000
Supercop,16249557,16249557,00000,,00000
Black Christmas,16235738,16235738,00000,29457214,9000000
Dasavatharam,16227750,00000,16227750,,00000
Kitaro And The Millennium Curse,16224319,00000,16224319,,00000
Cool Hand Luke,16217773,16217773,00000,,00000
Raw Deal,16209459,16209459,00000,,00000
Follow Me Boys,16207116,16207116,00000,,00000
Ghost Story,16202210,16202210,00000,,00000
The Emperor's Club,16193713,14060950,2132763,,12500000
Paranoia,16173593,7388654,8784939,83653,40000000
Un secret,16173558,623558,15550000,,00000
Just Visiting,16172200,4777007,11395193,,40000000
House of Sand and Fog,16157923,13005485,3152438,,16500000
Defending Your Life,16156857,16156857,00000,,00000
Richard Pryor Here and Now,16156776,16156776,00000,,00000
Mo' Better Blues,16153000,16153000,00000,,10000000
The Blue Max,16151612,16151612,00000,,00000
Fire Down Below,16148906,16148906,00000,,00000
Wes Craven Presents: They,16140842,12840842,3300000,,17000000
The Guardian,16140440,16140440,00000,,00000
D.C. Cab,16134000,16134000,00000,,00000
Winter's Bone,16131551,6531503,9600048,3734758,2000000
Imagine That,16123323,16123323,00000,,55000000
"Bright Lights, Big City",16118077,16118077,00000,,25000000
Death Wish 3,16116878,16116878,00000,,00000
Prancer,16115398,16115398,00000,,00000
Death Wish II,16100000,16100000,00000,,00000
No Holds Barred,16093651,16093651,00000,,00000
The Prophecy,16091660,16091660,00000,,00000
Running Turtle,16083981,00000,16083981,,00000
The Day of the Jackal,16056255,16056255,00000,,00000
Raaz 3: The Third Dimension,16042498,00000,16042498,,00000
Shine a Light,16040241,5371629,10668612,3949824,1000000
Incendies,16038343,6857096,9181247,,6800000
She's Having a Baby,16031707,16031707,00000,,00000
Above the Rim,16026469,16026469,00000,,00000
Purinsesu Toyotomi,16019696,00000,16019696,,00000
O (Othello),16017403,16017403,00000,,5000000
Devil in a Blue Dress,16004418,16004418,00000,,00000
The Devil and Max Devlin,16000000,16000000,00000,,00000
Forever Amber,16000000,16000000,00000,,00000
Mom and Dad,16000000,16000000,00000,,00000
Sinbad and the Eye of the Tiger,16000000,16000000,00000,,00000
Missing,16000000,16000000,00000,,00000
Our Man Flint,16000000,16000000,00000,,00000
Breakout,16000000,16000000,00000,,00000
Flirting with Disaster,15998144,14702438,1295706,,7000000
Tyler Perry's The Single Moms Club,15995891,15995891,00000,4643969,00000
Drowning Mona,15980376,15427192,553184,,16000000
Caveman,15965000,15965000,00000,,00000
Armed and Dangerous,15945534,15945534,00000,,00000
Cry Wolf,15943081,10047674,5895407,,1000000
Next of Kin,15942628,15942628,00000,,00000
Jason Goes to Hell: The Final Friday,15935068,15935068,00000,,3000000
Hero At Large,15934737,15934737,00000,,00000
Thomas and the Magic Railroad,15911332,15911332,00000,,19000000
The Conspirator,15907411,11538204,4369207,3451739,25000000
Ajab Prem Ki Ghazab Kahani,15906411,741238,15165173,,00000
Cai Shen Ke Zhan,15883398,00000,15883398,,00000
Big Eyes,15875318,14482031,1393287,1770559,10000000
Haevnen,15867314,1008098,14859216,,5500000
Dance With Me,15862680,15862680,00000,,00000
Gorky Park,15856028,15856028,00000,,00000
Crossing Delancey,15853838,15853838,00000,,00000
The Next Karate Kid,15851228,8751228,7100000,,00000
Heroine,15835948,598668,15237280,,00000
Extraordinary Measures,15826984,12482741,3344243,6648346,31000000
Anonymous,15815509,4463292,11352217,,27500000
The Ice Storm,15811546,7837632,7973914,,18000000
Kiss Me Goodbye,15782759,15782759,00000,,00000
The Gospel,15778152,15778152,00000,,00000
Blitz,15774948,00000,15774948,1601000,00000
Once Upon a Time in Mumbai,15753012,302862,15450150,,00000
Anjaana Anjaani,15738212,854757,14883455,,00000
Tazza: The High Rollers,15732936,00000,15732936,,00000
Jaws 4: The Revenge,15728335,15728335,00000,,23000000
Wes Craven's Wishmaster,15719109,15719109,00000,,00000
Double Dhamaal,15717126,543646,15173480,,00000
The Island,15716828,15716828,00000,,22000000
Fanaa,15707114,2105351,13601763,,00000
Avalon,15702685,15702685,00000,,00000
High Plains Drifter,15700000,15700000,00000,,15700000
The Last Station,15696146,6617867,9078279,,18000000
The Lion King (IMAX),15682879,15682879,00000,,00000
Larry the Cable Guy: Health Inspector,15680099,15680099,00000,13266667,17000000
Boule et Bill,15661615,56224,15605391,,00000
Made in Dagenham,15644196,1095369,14548827,,8000000
I Love You to Death,15600149,15600149,00000,,00000
Ulee's Gold,15600000,9054736,6545264,,2700000
Continental Divide,15578000,15578000,00000,,00000
Billy Bathgate,15565363,15565363,00000,,00000
Murder 2,15559302,00000,15559302,,00000
My Boss's Daughter,15549702,15549702,00000,,14000000
Switch,15545943,15545943,00000,,00000
The Getaway,15545115,15545115,00000,,00000
The Wild Angels,15541070,15541070,00000,,00000
Corvette Summer,15500000,15500000,00000,,00000
The Greatest Story Ever Told,15473333,15473333,00000,,20000000
Bait,15471969,15325127,146842,,35000000
The Weather Man,15466961,12482775,2984186,16735082,20000000
The Fountain,15461638,10144010,5317628,10978166,35000000
Facing Window,15458405,541682,14916723,,00000
The Jacket,15452978,6301131,9151847,,28500000
Youngblood,15448400,15448400,00000,,00000
Rocket Man,15448043,15448043,00000,,00000
In Too Deep,15447861,14003141,1444720,,7000000
Married to the Mafia 3,15447156,00000,15447156,,00000
Out of the Furnace,15434375,11330849,4103526,3039488,22000000
Catch and Release,15432542,15432542,00000,12504124,00000
The Bonfire of the Vanities,15432314,15432314,00000,,00000
Mad Love,15429108,15429108,00000,,00000
The Greatest Game Ever Played,15425073,15331289,93784,38191867,25000000
Still Smokin,15416684,15416684,00000,,00000
The Mod Squad,15415361,13260050,2155311,,00000
Tales from the Darkside: The Movie,15405624,15405624,00000,,00000
Touching the Void,15396525,4593598,10802927,,2000000
Death Warrant,15394200,15394200,00000,,00000
Pulse: A Stomp Odyssey,15384390,10086514,5297876,,00000
Mr. Destiny,15379253,15379253,00000,,00000
The Witches,15360553,10360553,5000000,,00000
Alex & Emma,15358583,14208384,1150199,,30000000
She-Devil,15351421,15351421,00000,,00000
Primeval,15337855,10597734,4740121,8265145,00000
Revenge,15335333,15335333,00000,,00000
The Haunting of Molly Hartley,15318257,13442412,1875845,10025541,5000000
The Assassination of Jesse James by the Coward Robert Ford,15313631,3909149,11404482,9885062,30000000
The Dreamers,15307337,2531462,12775875,,00000
Welcome Stranger,15300000,15300000,00000,,00000
"The Goods: Live Hard, Sell Hard",15297318,15122676,174642,,10000000
Maiko haaaan!!!,15287683,00000,15287683,,00000
Raavan,15284375,708726,14575649,,00000
Solomon Kane,15275793,00000,15275793,,00000
Quick Change,15260154,15260154,00000,,00000
Benji the Hunted,15212539,15212539,00000,,00000
Sweet Sweetback's Baad Asssss Song,15200000,15200000,00000,,150000
Celda 211,15200000,00000,15200000,,00000
First Family,15198912,15198912,00000,,00000
The Long Riders,15198912,15198912,00000,,10000000
Bad Girls,15187851,15187851,00000,,00000
Needful Things,15185672,15185672,00000,,00000
Miss Pettigrew Lives for a Day,15172953,12313694,2859259,3575358,00000
Thinner,15171475,15171475,00000,,14000000
The Corruptor,15164492,15164492,00000,,10000000
Chasing Amy,15155095,12006514,3148581,,250000
Iris,15155021,5580479,9574542,,5500000
Paradaisu Kisu,15141014,00000,15141014,,00000
La science des rêves,15137932,4670644,10467288,,6000000
Firestarter,15136870,15136870,00000,,15000000
I am Love,15132211,5005465,10126746,,10000000
Big Top Pee-Wee,15122324,15122324,00000,,00000
The Painted Veil,15118795,8060487,7058308,7622191,19400000
The Madness of King George,15110485,15110485,00000,,00000
Halloween:  The Curse of Michael Myers,15106362,15106362,00000,,5000000
Shingeki no kyojin endo obu za wârudo,15103794,243356,14860438,,00000
Muriel's Wedding,15103199,15103199,00000,,00000
Bhool Bhulaiyaa,15090039,1097797,13992242,,00000
Dead Man on Campus,15062898,15062898,00000,,14000000
Paradise Murdered,15061334,00000,15061334,,00000
King Solomon's Mines,15057465,15057465,00000,,00000
The Reef,15037867,00000,15037867,,10000000
Twilight,15030732,15030732,00000,,20000000
Zapped!,15026217,15026217,00000,,00000
Haakon Haakonsen,15024232,15024232,00000,,8500000
Trick 2,15016774,00000,15016774,,00000
The V.I.P.s,15000000,15000000,00000,,00000
The Egyptian,15000000,15000000,00000,,5000000
"Mother, Jugs & Speed",15000000,15000000,00000,,00000
The Front Page,15000000,15000000,00000,,4000000
Obitaemyy ostrov,15000000,00000,15000000,,36500000
Pete 'n' Tillie,14999969,14999969,00000,,00000
Breakin' 2: Electric Boogaloo,14981047,14981047,00000,,00000
Ek Main Aur Ekk Tu,14978029,1155545,13822484,,00000
Solaris,14970038,14970038,00000,,47000000
Matrimonio alle Bahamas,14964621,00000,14964621,,00000
Chak De India,14959326,1113541,13845785,,00000
The Music Man,14953846,14953846,00000,,00000
The Hudsucker Proxy,14938149,2816518,12121631,,40000000
Boat Trip,14933713,8586376,6347337,,15000000
The Meaning of Life,14929552,14929552,00000,,00000
Baarìa,14924887,00000,14924887,,00000
Kiss of Death,14924355,14924355,00000,,40000000
Mai wei,14911269,70177,14841092,,00000
Arn - Tempelriddaren,14900000,00000,14900000,,16500000
S.O.B.,14867086,14867086,00000,,00000
Dogville,14851654,1530386,13321268,,00000
Once Around,14851000,14851000,00000,,00000
Music of the Heart,14849583,14849583,00000,,00000
Pink Floyd: The Wall,14844106,14844106,00000,,00000
Hollywood Ending,14839383,4839383,10000000,,16000000
Enigma,14832284,4298329,10533955,,00000
Eve's Bayou,14821531,14821531,00000,,5000000
Flyboys,14816379,13090630,1725749,58159586,60000000
All I Want For Christmas,14812144,14812144,00000,,00000
Raise Your Voice,14811980,10411980,4400000,,15000000
A Dangerous Method,14807531,5702083,9105448,,20000000
Possession,14805812,10103647,4702165,,25000000
Going by the Book,14800000,00000,14800000,,00000
Ladybugs,14796494,14796494,00000,,00000
Prom Night,14796236,14796236,00000,,00000
Threesome,14793701,14793701,00000,,00000
Radio Days,14792779,14792779,00000,,16000000
Not Without My Daughter,14789113,14789113,00000,,00000
Out Cold,14786394,13906394,880000,,11000000
Over the Top,14765355,14765355,00000,,00000
The Sixth Man,14765099,14765099,00000,,00000
Fire Birds,14760451,14760451,00000,,00000
Les emotifs anonymes,14737098,00000,14737098,,00000
I Hate Luv Storys,14720564,847993,13872571,,00000
Orca,14717854,14717854,00000,,00000
Indian Summer,14717851,14717851,00000,,00000
Brooklyn,14717378,8108506,6608872,,00000
School Ties,14715067,14715067,00000,,00000
Men At Work,14707474,14707474,00000,,00000
Deutschland: Ein Sommermarchen,14700000,00000,14700000,,00000
Reversal of Fortune,14691480,14691480,00000,,00000
Khiladi 786,14683763,385422,14298341,,5600000
Iron Monkey,14681661,14681661,00000,,00000
Arthur 2: On the Rocks,14681192,14681192,00000,,00000
Case départ,14679847,00000,14679847,,00000
The Substitute,14675167,14675167,00000,,00000
The Nude Bomb,14662035,14662035,00000,,00000
Thank You,14660045,463540,14196505,,00000
Freedomland,14651216,12512886,2138330,7636503,00000
Winning,14644335,14644335,00000,,00000
Beyond the Lights,14618727,14618727,00000,1695294,7000000
A Life Less Ordinary,14611918,4266243,10345675,,00000
Birth,14603001,5005899,9597102,,20000000
Educating Rita,14593380,14593380,00000,,00000
Kiss of the Spider Woman,14582182,14582182,00000,,00000
Enfin Veuve,14580557,00000,14580557,,00000
Children of the Corn,14568989,14568989,00000,,00000
Soldier,14567883,14567883,00000,,75000000
Love & Mercy,14567806,12551031,2016775,746327,00000
Envy,14566246,13548322,1017924,,20000000
Cilada.com,14563149,00000,14563149,,00000
Wild at Heart,14560000,14560000,00000,,00000
Bikur Ha-Tizmoret,14555884,3053823,11502061,,00000
Soul Plane,14553807,13922211,631596,,16000000
Willard,14545941,14545941,00000,,00000
School Daze,14545844,14545844,00000,,6000000
The Vanishing,14543394,14543394,00000,,00000
Kickboxer,14533681,14533681,00000,,1500000
Chances Are,14527881,14527881,00000,,00000
Deux jours à Paris,14521665,4433994,10087671,,00000
Red Lights,14518884,49521,14469363,736789,17700000
Jackie Chan's First Strike,14511338,14511338,00000,,00000
Wadjda,14505102,1342455,13162647,,00000
"Oh, God! Book II",14504277,14504277,00000,,00000
McLintock!,14500000,14500000,00000,,00000
Being Julia,14488705,7739049,6749656,,18000000
King of Kings,14483352,14483352,00000,,00000
Psycho III,14481606,14481606,00000,,00000
A Kiss Before Dying,14478720,14478720,00000,,00000
Madeo,14472387,551509,13920878,,00000
Flight of the Intruder,14471440,14471440,00000,,35000000
Welcome to Mooseport,14469428,14469428,00000,,26000000
"Life, or Something Like It",14448589,14448589,00000,,40000000
America: Imagine a World Without Her,14444502,14444502,00000,2960506,00000
Maria Full of Grace,14441158,6529624,7911534,,3200000
Night of the Comet,14418922,14418922,00000,,00000
Los ojos de Julia,14404529,00000,14404529,,00000
Halloween 3: Season of the Witch,14400000,14400000,00000,,2500000
Trapeze,14400000,14400000,00000,,4000000
Tea with Mussolini,14395874,14395874,00000,,14000000
Remo Williams: The Adventure Begins,14393902,14393902,00000,,00000
Männersache,14378901,00000,14378901,,00000
Snow Falling on Cedars,14378353,14378353,00000,,36000000
Ishtar,14375181,14375181,00000,,40000000
City of Joy,14371061,14371061,00000,,00000
The Buddy Holly Story,14363400,14363400,00000,,00000
Memoirs of an Invisible Man,14358033,14358033,00000,,40000000
Rapid Fire,14356479,14356479,00000,,00000
Friday the 13th Part VIII: Jason Takes Manhattan,14343976,14343976,00000,,5000000
Hot Rod,14334401,13938332,396069,25280713,25000000
Dostana,14332659,1235028,13097631,,00000
Surviving Christmas,14328813,11198345,3130468,,00000
Excess Baggage,14327206,14327206,00000,,00000
Turistas,14321070,7027762,7293308,5384105,10000000
Tropa de Elite,14319195,08744,14310451,,6537890
Beginners,14314407,5790894,8523513,,3200000
On His Majesty's Secret Service,14303209,00000,14303209,,00000
The Mosquito Coast,14302000,14302000,00000,,00000
Blue Skies,14300000,14300000,00000,,00000
Grease 2,14297083,14297083,00000,,00000
Supergirl,14296438,14296438,00000,,00000
Ballistic: Ecks vs. Sever,14294842,14294842,00000,,70000000
Z,14283305,14283305,00000,,00000
The Wizard,14278900,14278900,00000,,00000
Baby: Secret of the Lost Legend,14276095,14276095,00000,,00000
The Messenger: The Story of Joan of Arc,14271297,14271297,00000,,50000000
The Chamber,14259205,14259205,00000,,00000
Sukkar banat,14253760,1060591,13193169,,1600000
Josie and the Pussycats,14252830,14252830,00000,,22000000
Freddy Got Fingered,14249005,14249005,00000,,15000000
Tinker Bell and the Legend of the Neverbeast,14243805,00000,14243805,9849880,00000
The Return of the Living Dead,14237880,14237880,00000,,4000000
Mere Brother Ki Dulhan,14233249,496172,13737077,,00000
Supernova,14218868,14218868,00000,,60000000
Woodlawn,14214579,14214579,00000,,00000
Sweet Liberty,14205021,14205021,00000,,00000
A Chorus Line,14202899,14202899,00000,,00000
Scanners,14200000,14200000,00000,,00000
The Eiger Sanction,14200000,14200000,00000,,00000
Highlander II: The Quickening,14184134,14184134,00000,,00000
Prince of Darkness,14182000,14182000,00000,,00000
The Snows of Kilimanjaro,14181330,13000000,1181330,,00000
Dirty Pretty Things,14156753,8112414,6044339,,10000000
Wholly Moses!,14155617,14155617,00000,,00000
Ernest Scared Stupid,14143280,14143280,00000,,00000
The Hospital,14142409,14142409,00000,,00000
In the Land of Women,14140402,11052958,3087444,10308560,10500000
Havana Nights: Dirty Dancing 2,14140215,14140215,00000,,00000
Little Children,14121177,5463019,8658158,3675500,14000000
Poltergeist III,14114000,14114000,00000,,9500000
Cool World,14110589,14110589,00000,,00000
How to Deal,14108518,14108518,00000,,16000000
Tomboy,14100000,14100000,00000,,00000
Leviathan,14090585,14090585,00000,,00000
Gegen die Wand,14060854,435395,13625459,,00000
Big Night,14058979,11881039,2177940,,00000
Fairytale: A True Story,14057929,14057929,00000,,00000
Private School,14049540,14049540,00000,,00000
My Left Foot: The Story of Christy Brown,14041353,14041353,00000,,00000
Shootout at Wadala,14038660,369310,13669350,,00000
Victor Frankenstein,14020761,4020761,10000000,,00000
The Arrival,14012411,14012411,00000,,00000
Def Jam's How To Be a Player,14008431,14008431,00000,,12000000
Scout's Guide to the Zombie Apocalypse,14003046,3703046,10300000,,15000000
Imitation of Life,14000000,14000000,00000,,00000
The Greek Tycoon,14000000,14000000,00000,,00000
Creepshow 2,14000000,14000000,00000,,3500000
The Night the Lights Went Out in Georgia,14000000,14000000,00000,,00000
The Survivors,14000000,14000000,00000,,00000
The Thomas Crown Affair,14000000,14000000,00000,,00000
David and Bathsheba,14000000,14000000,00000,,00000
Charlie and the Chocolate Factory (IMAX),14000000,14000000,00000,,00000
The Bad News Bears Go To Japan,14000000,14000000,00000,,00000
Un homme et une femme,14000000,14000000,00000,,00000
The Missouri Breaks,14000000,14000000,00000,,00000
Sharks 3D,14000000,8500000,5500000,,00000
Stand and Deliver,13994920,13994920,00000,,00000
The Sterile Cuckoo,13982357,13982357,00000,,00000
Blues Brothers 2000,13979599,13979599,00000,,00000
Stealing Harvard,13973532,13973532,00000,,25000000
Hong men yan,13969132,00000,13969132,,00000
Sesame Street Presents Follow That Bird,13961370,13961370,00000,,00000
Los amantes pasajeros,13941437,1359796,12581641,,00000
The Commitments,13931633,13931633,00000,,00000
Waltz with Bashir,13912289,2283849,11628440,,2000000
Candyman: Farewell to Flesh,13899536,13899536,00000,,00000
Stolen,13887877,289773,13598104,4618197,00000
Sophie Scholl - Die letzten Tage,13887199,680331,13206868,,00000
Religulous,13881317,13011160,870157,8727562,2500000
Les Miserables,13871914,13871914,00000,,00000
The Beauty Inside,13864573,108238,13756335,,00000
Seven Days,13857860,00000,13857860,,00000
My Stepmother Is an Alien,13854000,13854000,00000,,16000000
Smoke,13853284,8353284,5500000,,00000
"Angus, Thongs and Perfect Snogging",13835569,00000,13835569,,00000
Vykrutasy,13835287,00000,13835287,,00000
The Spanish Prisoner,13835130,10162034,3673096,,100000000
In the Mood for Love,13834044,2734044,11100000,,00000
The Milagro Beanfield War,13825794,13825794,00000,,00000
Lord of the Flies,13812230,13812230,00000,,00000
The Man Who Knew Too Little,13801755,13801755,00000,,20000000
Leave Her to Heaven,13800000,13800000,00000,,00000
"New York, New York",13800000,13800000,00000,,14000000
The Long Walk Home,13798030,13798030,00000,,00000
Toy Soldiers,13783137,13783137,00000,,00000
The Thing,13782838,13782838,00000,,00000
Juwanna Mann,13771817,13571817,200000,,15600000
The House of the Dead,13767816,10199354,3568462,,7000000
The Lady in the Van,13759422,00000,13759422,,00000
Wanted,13753723,349637,13404086,,00000
Blow Out,13747234,13747234,00000,,18000000
Trespass,13747138,13747138,00000,,00000
Drop Dead Fred,13746300,13746300,00000,,00000
Do You Believe?,13741342,12985600,755742,3185484,2300000
Highlander III: The Sorcerer,13738574,13738574,00000,,26000000
Body of Evidence,13734039,13734039,00000,,00000
One Night with the King,13725032,13395961,329071,20688299,20000000
The Ladies Man,13719474,13592872,126602,,11000000
A Kid in King Arthur's Court,13719230,13378668,340562,,00000
The Wings of the Dove,13718385,13718385,00000,,00000
She's the One,13711141,9398667,4312474,,3500000
Great Balls of Fire!,13691550,13691550,00000,,00000
The Sandpiper,13691111,13691111,00000,,00000
Return to Snowy River,13687027,13687027,00000,,00000
Hey Arnold! The Movie,13684949,13684949,00000,,10000000
Mutiny on The Bounty,13680000,13680000,00000,,19000000
Desperate Measures,13668777,13668777,00000,,00000
Knight Moves,13668149,923418,12744731,,00000
Vice Versa,13664060,13664060,00000,,00000
Buffy the Vampire Slayer,13662164,13662164,00000,,7000000
Spaced Invaders,13654536,13654536,00000,,3000000
The Gunman,13644292,10664749,2979543,1369823,40000000
Aarakshan,13643508,651096,12992412,,00000
The Company You Keep,13632449,5132442,8500007,,00000
The Crush,13609396,13609396,00000,,00000
Osmosis Jones,13596911,13596911,00000,,70000000
Fear and Loathing in Las Vegas,13594015,10562387,3031628,,18500000
Trial And Error,13587762,13587762,00000,,00000
Foxcatcher,13580559,12096300,1484259,1371284,00000
Tomcats,13558739,13558739,00000,,11000000
The Little Vampire,13555988,13555988,00000,,22000000
The Comebacks,13539154,13349927,189227,9324486,00000
Hush,13513622,13513622,00000,,00000
Mrs. Miniver,13500000,13500000,00000,,00000
Africa's Elephant Kingdom,13485455,13485455,00000,,00000
Le Havre,13480196,611709,12868487,,5500000
Charade,13474588,13474588,00000,,00000
Los tres entierros de Melquiades Estrada,13454474,5027684,8426790,5907320,15000000
Chasseurs de dragons,13446115,00000,13446115,,17000000
Sydney White,13446014,11702090,1743924,7065116,16500000
One Night at McCool's,13441957,6276532,7165425,,00000
Blind,13439098,00000,13439098,,00000
Beul-la-in-deu,13439098,00000,13439098,,00000
Tenacious D in: The Pick of Destiny,13434575,8334575,5100000,9483125,00000
The Deep End of the Ocean,13432982,13432982,00000,,40000000
Brideshead Revisited,13432256,6432256,7000000,,00000
One Crazy Summer,13431806,13431806,00000,,00000
The History Boys,13424361,2706659,10717702,,3700000
While We're Young,13422414,7582065,5840349,,10000000
Extremities,13418091,13418091,00000,,00000
Secrets & Lies,13417292,13417292,00000,,4500000
Tomorrow When the War Began,13404936,04936,13400000,,00000
The Legend of the Lone Ranger,13400000,13400000,00000,,18000000
Umimachi Diary,13392977,00000,13392977,,00000
Ooops! Noah is Gone,13388878,00000,13388878,,00000
Clue,13377261,13377261,00000,,00000
Labor Day,13371528,13371528,00000,3283947,18000000
Vera Drake,13353855,3753806,9600049,,11000000
Mr. Saturday Night,13351357,13351357,00000,,00000
Koneko monogatari,13349107,13299749,49358,,00000
The Sons of Katie Elder,13333333,13333333,00000,,00000
Hellraiser,13323420,13323420,00000,,1000000
Strange Magic,13311423,12429583,881840,2209511,00000
La Cage Doree,13300000,00000,13300000,,00000
Die Wilden Kerle 5,13300000,00000,13300000,,00000
The Pick-Up Artist,13290368,13290368,00000,,00000
The Entity,13277558,13277558,00000,,00000
North by Northwest,13275000,13275000,00000,,00000
Bio-Dome,13270797,13270797,00000,,00000
American Outlaws,13264986,13264986,00000,,35000000
One Magic Christmas,13229514,13229514,00000,,00000
Lord of Illusions,13229129,13229129,00000,,00000
Class Act,13226469,13226469,00000,,00000
FearDotCom,13208023,13208023,00000,,40000000
Crazy People,13204459,13204459,00000,,00000
Anything Else,13203044,3203044,10000000,,18000000
Bullets Over Broadway,13202987,13202987,00000,,20000000
Enchanted April,13200170,13200170,00000,,00000
Family Plot,13200000,13200000,00000,,3000000
Hanyo,13197026,149757,13047269,,00000
I Think I Love My Wife,13196245,12550605,645640,13623601,14000000
Regression,13190435,00000,13190435,,00000
The Honeymooners,13174426,12834849,339577,,27000000
Akmareul Boatda,13168809,129210,13039599,,6000000
Critters,13167232,13167232,00000,,00000
The Lords of Dogtown,13159280,11008432,2150848,,25000000
Greedy,13137484,13137484,00000,,00000
To Kill A Mockingbird,13129846,13129846,00000,5637316,2000000
Bye Bye Birdie,13129412,13129412,00000,,00000
Maundy Thursday,13117555,00000,13117555,,00000
Author! Author!,13111101,13111101,00000,,00000
The Incubus,13110874,13110874,00000,,00000
Rosewood,13104494,13104494,00000,,00000
The Evil That Men Do,13102025,13102025,00000,,00000
Hair,13100000,13100000,00000,,00000
How to Eat Fried Worms,13098996,13040527,58469,17129303,00000
In the Name of the King: A Dungeon Siege Tale,13075656,4775656,8300000,15754475,60000000
The Ice Pirates,13075390,13075390,00000,,9000000
Flowers in the Attic,13071365,13071365,00000,,00000
The Way of the Gun,13061935,6047856,7014079,,9000000
Ghosts of Mississippi,13052741,13052741,00000,,36000000
Angela's Ashes,13038660,13038660,00000,,25000000
Senseless,13035599,13035599,00000,,00000
To Be or Not to Be,13030214,13030214,00000,,00000
I'm Gonna Git You Sucka,13030057,13030057,00000,,00000
Student of the Year,13029482,326508,12702974,,00000
Crooklyn,13024170,13024170,00000,,14000000
The Crew,13019253,13019253,00000,,23000000
In Cold Blood,13007551,13000000,07551,,3500000
Spotlight,13004216,13004216,00000,,00000
Kinsey,13000959,10214647,2786312,,11000000
They Live,13000000,13000000,00000,,4000000
Hopscotch,13000000,13000000,00000,,00000
The Wiz,13000000,13000000,00000,,24000000
Stroker Ace,13000000,13000000,00000,,00000
Rich and Famous,13000000,13000000,00000,,00000
The Concorde: Airport '79,13000000,13000000,00000,,00000
The Competition,13000000,13000000,00000,,00000
Torn Curtain,13000000,13000000,00000,,3000000
On the Right Track,13000000,13000000,00000,,00000
Middle Age Crazy,13000000,13000000,00000,,00000
Time After Time,13000000,13000000,00000,,00000
The Pirates Who Don't Do Anything: A VeggieTales Movie,12994200,12727025,267175,9267298,15000000
Vision Quest,12993175,12993175,00000,,00000
Le Divorce,12985489,9074550,3910939,,00000
Man's Best Friend,12974636,12974636,00000,,00000
Bandslam,12967829,5210988,7756841,,20000000
Clockers,12963125,12963125,00000,,00000
Lone Star,12952403,12952403,00000,,5000000
Real Genius,12952019,12952019,00000,,00000
Mao's Last Dancer,12949849,4806750,8143099,,18000000
April Fool's Day,12947763,12947763,00000,,5000000
Slither,12930343,7802450,5127893,7624242,15250000
They Call Me Bruce,12925437,12925437,00000,,00000
Gods and Generals,12923936,12882934,41002,,55000000
Hatari!,12923077,12923077,00000,,00000
Perfect,12918858,12918858,00000,,00000
Thirst,12918574,318574,12600000,,00000
Hysteria,12917238,3337194,9580044,,00000
Searching for Sugar Man,12913491,3965090,8948401,2107897,00000
Los abrazos rotos,12910363,5014305,7896058,,00000
Living Out Loud,12902790,12902790,00000,,12000000
Sgt. Pepper's Lonely Hearts Club Band,12900000,12900000,00000,,00000
Highlander,12900000,5900000,7000000,,16000000
A Far Off Place,12890752,12890752,00000,,00000
Evening,12885574,12406646,478928,,00000
Deception,12850033,4598506,8251527,2782440,25000000
The Grifters,12850000,12850000,00000,,00000
Hamburger Hill,12841759,12841759,00000,,00000
The Last Married Couple in America,12835544,12835544,00000,,00000
The Perfect Weapon,12833672,12833672,00000,,00000
Black Dog,12829351,12829351,00000,,00000
Agent Vinrod,12822885,698210,12124675,,00000
Unfinished Business,12819501,10219501,2600000,925388,35000000
Mary Reilly,12807914,5615008,7192906,,47000000
Crayo Shin-chan Arashi wo Yobu Ohgon no Spy Daisakusen,12801345,00000,12801345,,00000
Highlander: Endgame,12801190,12801190,00000,,15000000
The Nun's Story,12800000,12800000,00000,,3500000
Meet Me in St. Louis,12800000,12800000,00000,,00000
Urmel aus dem Eis,12799144,00000,12799144,,00000
Marvin's Room,12782508,12782508,00000,,23000000
Mr. Wrong,12781045,12781045,00000,,00000
The Associate,12772657,12772657,00000,,00000
L'élève Ducobu,12767508,00000,12767508,,00000
Aliens of the Deep,12765684,8968684,3797000,,00000
Gekijoban Mahou Shojo Madoka Magica Shinpen Hangyoku no Monogatari,12762731,190478,12572253,,00000
The Evening Star,12747242,12747242,00000,,00000
Weekend at Bernie's II,12741891,12741891,00000,,00000
Labyrinth,12729917,12729917,00000,,00000
The Sapphires,12721854,2450867,10270987,,00000
Come September,12710696,12710696,00000,,00000
D.O.A.,12706478,12706478,00000,,00000
Come Blow Your Horn,12705882,12705882,00000,,00000
"Move Over, Darling",12705882,12705882,00000,,00000
"Bon Cop, Bad Cop",12697976,12628571,69405,,8000000
The Omega Code,12678312,12610552,67760,,7200000
The Dressmaker,12665029,00000,12665029,,00000
Chasing Papi,12657377,6126237,6531140,,9000000
Last Night,12646519,112087,12534432,,00000
The Bedroom Window,12640385,12640385,00000,,00000
Everybody's All American,12638294,12638294,00000,,00000
Bad Influence,12626043,12626043,00000,,00000
Extreme Ops,12624471,4835968,7788503,,40000000
Frenzy,12600000,12600000,00000,,3500000
"They Shoot Horses, Don't They?",12600000,12600000,00000,,00000
Diner,12592907,12592907,00000,,5000000
The Spitfire Grill,12592203,12592203,00000,,00000
A Love,12592135,00000,12592135,,00000
Gossip,12591270,5108820,7482450,,14000000
Visiting Hours,12581713,12581713,00000,,00000
Bachelorette,12577401,446770,12130631,1577589,3000000
Idlewild,12571185,12571185,00000,8762876,15000000
Hellraiser III: Hell on Earth,12525537,12525537,00000,,00000
Sorority Boys,12516222,10198766,2317456,,12000000
Love Jones,12514138,12514138,00000,,10000000
Klute,12512637,12512637,00000,,00000
Breakin' All the Rules,12512317,12232382,279935,,9000000
Hak hap,12504289,12504289,00000,,00000
The Song of Bernadette,12500000,12500000,00000,,00000
War and Peace,12500000,12500000,00000,,6000000
Father Goose,12500000,12500000,00000,,00000
Mystic Pizza,12465564,12465564,00000,,6000000
Hot Tub Time Machine 2,12452601,12314651,137950,1099323,14000000
Material Girls,12449638,11449638,1000000,12190548,00000
Kai Po Che,12432815,1122527,11310288,,00000
People Like Us,12431792,12431792,00000,4641067,16000000
Boy s tenyu 2,12426015,00000,12426015,,00000
The Cold Light of Day,12425385,3763583,8661802,4564940,20000000
Knockaround Guys,12419700,11660180,759520,,15000000
Undercover Blues,12416686,12416686,00000,,00000
Why Do Fools Fall In Love?,12413650,12413650,00000,,00000
Nueve Reinas,12412889,1222889,11190000,,1500000
Monsignor,12408066,12408066,00000,,00000
The Bling Ring,12407491,5845732,6561759,898731,00000
Bella,12405473,8093373,4312100,5985106,3300000
Atrapa la bandera,12404980,00000,12404980,,00000
Undisputed,12398628,12398628,00000,,20000000
I'm Not There,12397613,4017609,8380004,6059232,20000000
Less than Zero,12396383,12396383,00000,,00000
Irreconcilable Differences,12384120,12384120,00000,,00000
Shaolin Girl,12380512,00000,12380512,,00000
The Andromeda Strain,12376563,12376563,00000,,6500000
Ready to Rumble,12372410,12372410,00000,,24000000
A Shot in the Dark,12368234,12368234,00000,,00000
Life With Mikey,12349549,12349549,00000,,00000
Soul Men,12345883,12082391,263492,11618723,40000000
The Interview,12342632,6105175,6237457,3614589,44000000
Gattaca,12339633,12339633,00000,,36000000
Millions,12337828,6584159,5753669,,00000
Street Fighter: The Legend of Chun-Li,12335036,9135036,3200000,5903599,50000000
The Ref,12325885,11325885,1000000,,00000
Eye for an Eye,12314832,00000,12314832,,00000
Gu Dao Jing Hun,12312603,00000,12312603,,00000
True Romance,12309980,12281000,28980,,12500000
Club Paradise,12308521,12308521,00000,,00000
No Mercy,12303904,12303904,00000,,00000
Enemy Mine,12303411,12303411,00000,,00000
Escape from the Planet of the Apes,12300000,12300000,00000,,2500000
Chasing Liberty,12291975,12189514,102461,,23000000
A Stranger Among Us,12282994,12282994,00000,,00000
Casual Sex?,12277096,12277096,00000,,00000
"Titeuf, Le Film",12268517,00000,12268517,,00000
My Life Without Me,12267275,432360,11834915,,2500000
Dark Blue,12262065,9237470,3024595,,15000000
Whiteout,12254746,10275638,1979108,3786391,35000000
Lejdis,12247829,00000,12247829,,00000
L&aring;t den rätte komma in,12247682,2122085,10125597,3950286,4500000
Lone Wolf McQuade,12232628,12232628,00000,,5000000
The Lunchbox,12231500,4231500,8000000,,1700000
Abandon,12219367,10719367,1500000,,25000000
I'll Be Home For Christmas,12213678,12213678,00000,,00000
Confidence,12212417,12212417,00000,,15000000
Back to the Beach,12208754,12208754,00000,,00000
True Confessions,12200000,12200000,00000,,00000
Office Space,12176816,10824921,1351895,,10000000
9 mois ferme,12170407,154485,12015922,,00000
Zoom,12148105,11631245,516860,12610569,35000000
Babies,12146819,7320323,4826496,3078272,00000
The Fourth Protocol,12144184,12144184,00000,,00000
Le Coeur des hommes 2,12130156,00000,12130156,,00000
The Vatican Tapes,12127591,1784763,10342828,30483,13000000
Little Big League,12124754,12124754,00000,,00000
Shaft,12121618,12121618,00000,,00000
Montajoo,12116647,00000,12116647,,00000
Dreamscape,12116365,12116365,00000,,00000
Judgment Night,12108480,12108480,00000,,00000
Hideaway,12102215,12102215,00000,,00000
Help!,12066667,12066667,00000,,00000
Holy Man,12065985,12065985,00000,,60000000
She's Out of Control,12065892,12065892,00000,,00000
The King and I,12064440,12064440,00000,,00000
Dave Chappelle's Block Party,12051924,11718595,333329,18800691,3000000
Fatal Beauty,12046526,12046526,00000,,00000
How to Lose Friends & Alienate People,12031443,2775593,9255850,,28000000
Harry Brown,12023606,1818681,10204925,,7300000
The Marrying Man,12003886,12003886,00000,,00000
Bandolero!,12000000,12000000,00000,,00000
Fantastic Voyage,12000000,12000000,00000,,00000
The Frisco Kid,12000000,12000000,00000,,00000
Divorce American Style,12000000,12000000,00000,,00000
Hombre,12000000,12000000,00000,,00000
The Big Fix,12000000,12000000,00000,,00000
First Monday in October,12000000,12000000,00000,,00000
Sorcerer,12000000,12000000,00000,,21600000
The Postman Always Rings Twice,12000000,12000000,00000,,00000
French Connection II,12000000,12000000,00000,,00000
The Other Side of the Mountain Part II,12000000,12000000,00000,,00000
The Changeling,12000000,12000000,00000,,00000
Harper,12000000,12000000,00000,,3500000
Tall Story,12000000,12000000,00000,,00000
Gentlemen Prefer Blondes,12000000,12000000,00000,,00000
Race with the Devil,12000000,12000000,00000,,00000
The Sea Chase,12000000,12000000,00000,,00000
Frankenstein,12000000,12000000,00000,,00000
Physical Evidence,12000000,12000000,00000,,00000
The Tall Men,12000000,12000000,00000,,00000
How to Murder Your Wife,12000000,12000000,00000,,00000
Cape No. 7,12000000,00000,12000000,,00000
De Dana Dan,11998249,944979,11053270,,00000
Warum Männer nicht zuhören und Frauen schlecht einparken,11996501,00000,11996501,,00000
"4 luni, 3 saptamani si 2 zile",11993156,1196321,10796835,,900000
The Pagemaster,11992698,11992698,00000,,00000
Sluzhebnyy roman. Nashye vryemya,11990788,00000,11990788,,00000
Rudo y Cursi,11987924,1827660,10160264,,00000
Nuovo cinema Paradiso,11985152,11985152,00000,,00000
Bye Bye Love,11959497,11959497,00000,,00000
Brighton Beach Memoirs,11957943,11957943,00000,,00000
Diana,11946983,335360,11611623,722417,00000
Roommates,11933937,11933937,00000,,00000
In Dreams,11927682,11927682,00000,,30000000
End of the Spear,11924041,11748661,175380,,10000000
Mulholland Drive,11919578,7219578,4700000,,15000000
Duong Gia Tuong,11906509,00000,11906509,,00000
Making Love,11897978,11897978,00000,,00000
Katyn,11882290,118095,11764195,,00000
The Way,11882191,4430650,7451541,6083499,00000
The Gate,11872510,11872510,00000,,00000
Win Win,11869063,10179275,1689788,,00000
Kal Ho Naa Ho,11862035,1956478,9905557,,00000
Action Replayy,11857228,410262,11446966,,00000
Narc,11843260,10465659,1377601,,7500000
Don't Move,11837603,103280,11734323,,00000
Firewalker,11834302,11834302,00000,,00000
Chloe,11831131,3075255,8755876,,13000000
Year of the Gun,11820000,11820000,00000,,00000
Getaway,11813989,10501938,1312051,22437,18000000
The Thirteenth Floor,11810854,11810854,00000,,16000000
Back Roads,11809387,11809387,00000,,00000
Bloodsport,11806119,11806119,00000,,1500000
Yankee Doodle Dandy,11800000,11800000,00000,,00000
The Rules of Attraction,11799060,6525762,5273298,,4000000
Zelig,11798616,11798616,00000,,00000
Caddyshack II,11798302,11798302,00000,,00000
This Must Be the Place,11792060,142242,11649818,,00000
Tales from the Hood,11784569,11784569,00000,,6000000
Saekjeuk shigong 2,11780198,00000,11780198,,00000
The Thrill of it All,11779093,11779093,00000,,00000
The Longshots,11778396,11511323,267073,10960318,23000000
Crayon Shinchan 15,11777171,00000,11777171,,00000
Shopgirl,11758418,10284523,1473895,10666674,7500000
Micmacs,11756922,1259693,10497229,,42000000
Gunfight at the O.K. Corral,11750000,11750000,00000,,00000
Hoop Dreams,11746701,7746701,4000000,,700000
3 Ninjas Kick Back,11744960,11744960,00000,,20000000
Layer Cake,11744669,2338695,9405974,,6500000
The Great Escape,11744471,11744471,00000,,4000000
Ca&#36;h,11738256,00000,11738256,,00000
Strictly Ballroom,11738000,11738000,00000,,00000
Quills,11732088,7060876,4671212,,13500000
Fading Gigolo,11723272,3747833,7975439,374904,00000
The Lords of Discipline,11721041,11721041,00000,,00000
Used Cars,11715321,11715321,00000,,00000
The Son's Room,11714416,1014416,10700000,,00000
Up the Creek,11708269,11708269,00000,,00000
Closer to Heaven,11701551,00000,11701551,,00000
Beauty and the Beast,11700000,00000,11700000,,00000
Rock-a-Doodle,11657385,11657385,00000,,00000
The Pyramid,11656333,2756333,8900000,,00000
Smart People,11655619,9511289,2144330,3627638,00000
Halloween 5: The Revenge of Michael Myers,11642254,11642254,00000,,6000000
What a Man,11639918,00000,11639918,,00000
Khatta Meetha,11635261,541904,11093357,,00000
The Adventures of Elmo in Grouchland,11634458,11634458,00000,,17000000
Dum Maaro Dum,11633427,564489,11068938,,00000
The Muse,11614954,11614954,00000,,15000000
The Last Kiss,11614790,11614790,00000,,00000
Taare Zameen Par,11613178,1223869,10389309,,00000
Hellraiser II: Hellbound,11611883,11611883,00000,,00000
Faubourg 36,11610575,850575,10760000,,00000
Lifeforce,11603545,11603545,00000,,25000000
Wara No Tate,11601232,00000,11601232,,00000
Finian's Rainbow,11600000,11600000,00000,,00000
Banlieue 13,11599903,1200216,10399687,,15000000
So I Married an Axe Murderer,11585483,11585483,00000,,00000
Graveyard Shift,11578883,11578883,00000,,00000
Wing Commander,11578022,11578022,00000,,30000000
Police Academy 6: City Under Siege,11567000,11567000,00000,,00000
Iron Sky,11565792,122082,11443710,,00000
The Order,11559747,7659747,3900000,,35000000
The Legend of Drunken Master,11546543,11546543,00000,,2000000
The Cookout,11540112,11540112,00000,,16000000
Tsotsi,11537539,2912606,8624933,,3000000
Young Einstein,11536599,11536599,00000,,00000
Bhoothnath,11532795,449776,11083019,,00000
Drop,11528993,00000,11528993,,00000
The Quiet  Ones,11509867,8509867,3000000,863260,00000
Alaska,11500372,11500372,00000,,00000
Galapagos,11500000,11500000,00000,,00000
The Sessions,11495204,6002451,5492753,,1000000
Something New,11483669,11468568,15101,5987196,00000
99 francs,11479477,79477,11400000,,00000
Turbulence,11466088,11466088,00000,,55000000
Teen Maar,11459148,00000,11459148,,00000
Elegy,11459039,3577210,7881829,,00000
The Beautician and the Beast,11454593,11454593,00000,,00000
Moon Over Parador,11444204,11444204,00000,,00000
Beyond Borders,11427090,4426297,7000793,,60000000
The Birds,11403529,11403529,00000,,00000
Sphinx,11400000,2000000,9400000,,10000000
Just One of the Guys,11377655,11377655,00000,,00000
Mulholland Falls,11375390,11375390,00000,,00000
Thumbelina,11373501,11373501,00000,,00000
Cops and Robbersons,11363618,11363618,00000,,00000
Hui Buh - Das Schlossgespenst,11361720,00000,11361720,,00000
Opportunity Knocks,11359129,11359129,00000,,00000
Reign of Assassins,11354230,00000,11354230,,00000
Snow Flower and the Secret Fan,11348205,1348205,10000000,,6000000
Gross Anatomy,11346186,11346186,00000,,00000
"Hexe Lilli, der Drache und das magische Buch",11338495,00000,11338495,,00000
The Man Who Knew Too Much,11333333,11333333,00000,,00000
Manhattan Murder Mystery,11330911,11330911,00000,,00000
Amityville II: The Possession,11328000,11328000,00000,,00000
Beyaz Melek,11323769,00000,11323769,,00000
Water,11322573,5529144,5793429,,3000000
American Me,11318100,11318100,00000,,00000
Double Team,11313010,11313010,00000,,00000
Extreme Prejudice,11307844,11307844,00000,,00000
Leave It To Beaver,11307615,11307615,00000,,00000
Spanish Movie,11305452,00000,11305452,,00000
Far from Home: The Adventures of Yellow Dog,11301050,11301050,00000,,00000
Who's the Man?,11299730,11299730,00000,,00000
Toshokan Senso,11294442,00000,11294442,,00000
Before Sunset,11293790,5792822,5500968,,2000000
La fille du puisatier,11284346,389651,10894695,,00000
Jennifer Eight,11281492,11281492,00000,,00000
Lars and the Real Girl,11277119,5956480,5320639,5832590,12500000
Frances Ha,11267511,4067398,7200113,,00000
Chill Factor,11263966,11263966,00000,,34000000
Son of Rambow: A Home Movie,11263263,1785505,9477758,,2000000
Shanghai,11258055,46425,11211630,,00000
Straw Dogs,11253821,10324441,929380,12998811,25000000
Balto,11249665,11249665,00000,,00000
Roving Mars,11248978,10407978,841000,,00000
Cyberworld 3D,11243857,11243857,00000,,00000
Hyde Park on Hudson,11242438,6376145,4866293,1607700,00000
La flûte à six schtroumpfs,11234220,11234220,00000,,00000
Stop-Loss,11229035,10915744,313291,5161124,25000000
Superman IV: The Quest for Peace,11227824,11227824,00000,,17000000
La Graine et le Mulet,11207864,203490,11004374,,00000
Q & A,11207000,11207000,00000,,00000
Assalto ao Banco Central,11200000,00000,11200000,,00000
The Squid and the Whale,11191423,7372734,3818689,,1500000
What a Way to Go!,11180531,11180531,00000,,00000
King Solomon's Mines,11172000,11172000,00000,,00000
The Cardinal,11170588,11170588,00000,,00000
Never Let Me Go,11158796,2419730,8739066,2771272,15000000
Les Gamins,11146589,00000,11146589,,00000
Deep Rising,11146409,11146409,00000,,45000000
Barney's Great Adventure,11144518,11144518,00000,,15000000
The Astronaut Farmer,11141213,11003643,137570,13903626,13000000
Tank,11131530,11131530,00000,,00000
V.I. Warshawski,11128309,11128309,00000,,00000
Pink Cadillac,11125820,11125820,00000,,00000
Whispers in the Dark,11124511,11124511,00000,,00000
Brokedown Palace,11115766,10115014,1000752,,25000000
Zhan Guo,11111761,68961,11042800,,00000
Please Don't Eat the Daisies,11100000,11100000,00000,,00000
2 Days In The Valley,11090856,11090856,00000,,00000
The Cooler,11083763,8243880,2839883,,4000000
Gypsy,11076923,11076923,00000,,00000
My Family,11075827,11075827,00000,,00000
The Unsinkable Molly Brown,11070559,11070559,00000,,00000
Tokyo Tower: Mom and Me and Sometimes Dad,11061179,00000,11061179,,00000
Family Business,11053835,11053835,00000,,00000
Krush Groove,11052713,11052713,00000,,3000000
Aashiqui 2,11046634,00000,11046634,,00000
Jonah Hex,11022696,10547117,475579,7866112,47000000
The Couch Trip,11005304,11005304,00000,,00000
The Last Flight of Noah’s Ark,11000000,11000000,00000,,00000
Wild Orchid,11000000,11000000,00000,,00000
Bite the Bullet,11000000,11000000,00000,,00000
It's My Turn,11000000,11000000,00000,,00000
Tom Sawyer,11000000,11000000,00000,,00000
American Hot Wax,11000000,11000000,00000,,00000
Cold Turkey,11000000,11000000,00000,,00000
Hangar 18,11000000,11000000,00000,,00000
The Lost Weekend,11000000,11000000,00000,,1250000
Wolfen,11000000,11000000,00000,,00000
The Golden Voyage of Sinbad,11000000,11000000,00000,,00000
Raggedy Man,11000000,11000000,00000,,00000
A Farewell To Arms,11000000,11000000,00000,,5000000
On the Beach,11000000,11000000,00000,,00000
A Hole in the Head,11000000,11000000,00000,,00000
In Like Flint,11000000,11000000,00000,,00000
Gator,11000000,11000000,00000,,00000
The Mirror Crack'd,11000000,11000000,00000,,00000
Show Boat,11000000,11000000,00000,,2300000
Solomon and Sheba,11000000,11000000,00000,,5000000
The Birth of a Nation,11000000,10000000,1000000,,110000
Pat Garrett and Billy the Kid,11000000,8000000,3000000,,4638783
Friends with Kids,10985652,7251073,3734579,3583230,00000
Who's Harry Crumb?,10982364,10982364,00000,,00000
The Man Who Loved Women,10964231,10964231,00000,,00000
Nuns on the Run,10959015,10959015,00000,,00000
Black Snake Moan,10951153,9396870,1554283,21941134,15000000
What the #$'! Do We Know,10941801,10941801,00000,,4000000
Le pacte des loups,10928863,10928863,00000,,00000
Senna,10924647,1612430,9312217,,00000
Cookie's Fortune,10919177,10919177,00000,,00000
Garfield's Pet Force,10918505,00000,10918505,,00000
Big Trouble in Little China,10911690,10911690,00000,,25000000
Fun Size ,10911519,9409538,1501981,,14000000
Kismat Konnection,10903927,479759,10424168,,00000
Flying Monsters 3D,10894223,5751141,5143082,,00000
"The Englishman Who Went Up a Hill, But Came Down a Mountain",10882631,10882631,00000,,00000
The Pink Panther,10878107,10878107,00000,,00000
The Man in the Gray Flannel Suit,10875000,10875000,00000,,00000
Narrow Margin,10873237,10873237,00000,,00000
Himmatwala,10871870,270880,10600990,,00000
Jannet 2,10858608,00000,10858608,,00000
Extract,10849158,10823158,26000,,7500000
Here on Earth,10845127,10494147,350980,,15000000
The Hole,10834406,00000,10834406,,7500000
Samyy luchshiy film 3,10832328,00000,10832328,,00000
You Can Count on Me,10827356,9180275,1647081,,1200000
Pump Up the Volume,10816769,10816769,00000,,00000
Moving,10815378,10815378,00000,,00000
Silver Bullet,10803211,10803211,00000,,7000000
Career Opportunities,10787500,10787500,00000,,00000
Away From Her,10787490,4548331,6239159,,00000
The Night Listener,10770993,7836393,2934600,8948938,4000000
We Need to Talk About Kevin,10765283,1738692,9026591,,7000000
New York Stories,10763469,10763469,00000,,15000000
Prom,10763183,10130219,632964,1632933,8000000
Missing in Action 2: The Beginning,10755447,10755447,00000,,00000
The Beastmaster,10751126,10751126,00000,,5000000
The African Queen,10750000,10750000,00000,,00000
Flower Drum Song,10738117,10738117,00000,,00000
Stay Tuned,10736401,10736401,00000,,00000
Not Easily Broken,10732909,10572742,160167,15169548,5000000
Gettysburg,10731997,10731997,00000,,25000000
Glengarry Glen Ross,10725228,10725228,00000,,12500000
The Drop,10724389,10724389,00000,1603973,00000
Universal Soldier II: The Return,10717421,10447421,270000,,40000000
For Love or Money,10709430,10709430,00000,,00000
Pure Country,10705365,10705365,00000,,00000
The Fiendish Plot of Dr. Fu Manchu,10697276,10697276,00000,,00000
RoboCop 3,10696210,10696210,00000,,22000000
Mad Dog and Glory,10688490,10688490,00000,,00000
Make It Happen,10688486,00000,10688486,,00000
"The Adventures of Priscilla, Queen of the Desert",10680877,10680877,00000,,00000
Moon,10676073,5010163,5665910,3072397,5000000
The Astronaut's Wife,10672566,10672566,00000,,34000000
The End of the Affair,10660147,10660147,00000,,23000000
Rab Ne Bana Di Jodi,10659346,2074346,8585000,,00000
Island of the Sharks,10658756,10658756,00000,,00000
The Package,10647219,10647219,00000,,00000
De père en flic,10644453,10644453,00000,,00000
Dirty Carnival,10638098,00000,10638098,,00000
The Purple Rose of Cairo,10631333,10631333,00000,,00000
The Boondock Saints 2: All Saints Day,10629320,10273187,356133,24280907,8000000
The Savages,10629267,6610326,4018941,,9000000
The Super,10627423,10627423,00000,,00000
Tengoku de kimi ni aetara,10625731,00000,10625731,,00000
Shattered,10621830,10621830,00000,,00000
The Virgin Suicides,10619770,4859475,5760295,,6000000
Return to Oz,10618813,10618813,00000,,27000000
Happy Birthday To Me,10609514,10609514,00000,,00000
After Hours,10609321,10609321,00000,,00000
Dracula: Dead and Loving It,10601599,10601599,00000,,00000
Play Misty for Me,10600000,10600000,00000,,00000
Kabadayi,10599297,00000,10599297,,00000
Falling in Love,10597500,10597500,00000,,00000
The Great Raid,10597070,10166502,430568,,60000000
Drop Dead Gorgeous,10571408,10571408,00000,,10000000
Three to Tango,10570375,10570375,00000,,20000000
Deconstructing Harry,10569071,10569071,00000,,20000000
Broadway Danny Rose,10566714,10566714,00000,,00000
Looking for Eric,10559972,55804,10504168,,00000
Pollock,10557291,8596914,1960377,,6000000
Compromising Positions,10556383,10556383,00000,,00000
Mad City,10556196,10556196,00000,,50000000
Husbands and Wives,10555619,10555619,00000,,00000
We're No Angels,10555348,10555348,00000,,20000000
Moving Violations,10551193,10551193,00000,,00000
Moms’ Night Out,10537341,10429707,107634,4984253,5000000
Les Tuche,10537035,00000,10537035,,00000
Crayon Shin-chan 16,10536987,00000,10536987,,00000
Where the Boys Are '84,10530000,10530000,00000,,00000
Love in Space,10519963,33976,10485987,,00000
American Ninja,10499000,10499000,00000,,00000
Two if by Sea,10493670,10493670,00000,,00000
Silent Rage,10490791,10490791,00000,,00000
The Accidental Husband,10484999,00000,10484999,,00000
Solace,10483236,00000,10483236,,00000
The Collector,10473836,7712114,2761722,2722939,00000
Teri Meri Kahaani,10471728,671442,9800286,,00000
Steamboy,10468867,468867,10000000,,20000000
Casablanca,10462500,10462500,00000,,1039000
Dangerous Liaisons,10447579,17000,10430579,,24200000
Home Fries,10443316,10443316,00000,,15000000
Blue Hawaii,10440453,10440453,00000,,00000
Operation Condor,10440032,10440032,00000,,00000
Beautiful Girls,10439854,10439854,00000,,00000
No Love in the City,10439457,00000,10439457,,00000
Camp Nowhere,10438786,10438786,00000,,00000
Interiors,10432366,10432366,00000,,00000
LOL,10431506,00000,10431506,4261692,11000000
First Daughter,10419084,9055010,1364074,,30000000
Sex Drive,10412485,8402485,2010000,10921159,19000000
Habemus Papam,10404075,486902,9917173,,00000
Moby Dick,10400000,10400000,00000,,4500000
The High and the Mighty,10400000,10400000,00000,,00000
Elmer Gantry,10400000,10400000,00000,,3000000
Head Over Heels,10397365,10397365,00000,,14000000
The Man,10393696,8330720,2062976,,20000000
Stardust Memories,10389003,10389003,00000,,00000
Jeonseolui Joomeok,10388780,134213,10254567,,00000
The Perfect Score,10387706,10387706,00000,,00000
Ma-dang-eul Na-on Am-talk,10387515,00000,10387515,,00000
Doctor Detroit,10375893,10375893,00000,,00000
One Good Cop,10370221,10370221,00000,,00000
Deal of the Century,10369581,10369581,00000,,00000
Thief of Hearts,10364904,10364904,00000,,00000
Town & Country,10364769,6712451,3652318,,105000000
The Scarlet Letter,10359006,10359006,00000,,50000000
Satyagraha,10329878,738525,9591353,,00000
Revenge of the Ninja,10325628,10325628,00000,,00000
I Got the Hook-Up!,10305534,10305534,00000,,3500000
The Newton Boys,10297897,10297897,00000,,27000000
Better Off Dead...,10297601,10297601,00000,,00000
All is Lost,10292010,6263670,4028340,3215804,8500000
Lubov Morkov,10291446,00000,10291446,,00000
Facing the Giants,10243159,10178331,64828,39682778,100000
White Squall,10229300,10229300,00000,,38000000
In the Mix,10223896,10223896,00000,,00000
Babes in Toyland,10218316,10218316,00000,,00000
Rollover,10217873,10217873,00000,,00000
Snabba Cash,10212403,188870,10023533,,4300000
I'll Do Anything,10209111,10209111,00000,,00000
Saved!,10206551,8886160,1320391,,5000000
The Brothers McMullen,10202068,10202068,00000,,50000
Woman on Top,10192613,5018450,5174163,,8000000
Flowers in the Shadow,10188284,00000,10188284,,00000
You So Crazy,10184701,10184701,00000,,00000
Next Day Air,10172519,10027047,145472,10422491,3000000
Look Who's Talking Now,10172124,10172124,00000,,00000
Henry V,10161099,10161099,00000,,9000000
Sexy Beast,10158355,6946056,3212299,,4300000
Punisher: War Zone,10157534,8050977,2106557,11870365,35000000
The Ice Harvest,10156968,9016782,1140186,7886257,00000
Bats,10155691,10155691,00000,,6500000
Lovesick,10143618,10143618,00000,,10100000
The Secret of Nimh,10140325,10140325,00000,,00000
ABCD (Any Body Can Dance),10137234,222098,9915136,,1900000
Father of the Bride,10135000,10135000,00000,,00000
Sunset Park,10128314,10128314,00000,,00000
Thunder and the House of Magic,10124184,04091,10120093,38902,34000000
Conviction,10118985,6783129,3335856,6249759,12500000
L'Allenatore Ne Pallone 2,10116005,00000,10116005,,00000
Away We Go,10108016,9451946,656070,5249525,21000000
Bernie,10106975,9204489,902486,2127680,6000000
The Wash,10097096,10097096,00000,,4000000
With Six You Get Eggroll,10095200,10095200,00000,,00000
Air Bud: Golden Receiver,10093523,10093523,00000,,00000
Under the Cherry Moon,10090429,10090429,00000,,00000
Lost in America,10079206,10079206,00000,,00000
Knock Off,10076136,10076136,00000,,35000000
Duplex,10070651,9652000,418651,,40000000
Shakedown,10068039,10068039,00000,,00000
Taking Woodstock,10066366,7460204,2606162,,29000000
Yokame no semi,10064960,00000,10064960,,00000
Boiling Point,10058318,10058318,00000,,00000
A Day Without a Mexican,10058001,4180870,5877131,,00000
Cyrus,10055042,7461082,2593960,,7000000
Open City,10051886,00000,10051886,,00000
Wüstenblume,10042267,00000,10042267,,00000
Mrs. Winterbourne,10039566,10039566,00000,,25000000
Godzilla 2000,10037390,10037390,00000,,1000000
Milyang,10031302,00000,10031302,,00000
Cyborg,10030875,10030875,00000,,00000
For Greater Glory,10026255,5669081,4357174,2147298,12000000
Le Violon rouge,10019109,10019109,00000,,10000000
Lucky Numbers,10014234,10014234,00000,,65000000
The Unbearable Lightness of Being,10006000,10006000,00000,,00000
The Two Jakes,10005969,10005969,00000,,00000
Buddy,10005081,10005081,00000,,00000
A Little Princess,10004169,10004169,00000,,00000
"Zorro, The Gay Blade",10000000,10000000,00000,,00000
The Singing Fool,10000000,10000000,00000,,00000
Up the Academy,10000000,10000000,00000,,00000
Journey to the Center of the Earth,10000000,10000000,00000,,00000
The Snake Pit,10000000,10000000,00000,,00000
Hud,10000000,10000000,00000,,2500000
King Kong,10000000,10000000,00000,,672000
The Big Doll House,10000000,10000000,00000,,00000
Atlantic City,10000000,10000000,00000,,00000
Iron Eagle II,10000000,10000000,00000,,00000
The Last Detail,10000000,10000000,00000,,00000
The Ambushers,10000000,10000000,00000,,00000
California Split,10000000,10000000,00000,,00000
State Fair,10000000,10000000,00000,,00000
Judgment at Nuremberg,10000000,10000000,00000,,3000000
The Dolly Sisters,10000000,10000000,00000,,00000
Mother Wore Tights,10000000,10000000,00000,,00000
Shaft's Big Score,10000000,10000000,00000,,00000
The Big Country,10000000,10000000,00000,,00000
Across 110th Street,10000000,10000000,00000,,00000
Gilda,10000000,10000000,00000,,00000
55 Days at Peking,10000000,10000000,00000,,17000000
Love Is a Many-Splendored Thing,10000000,10000000,00000,,00000
The Swarm,10000000,10000000,00000,,00000
Maniac,10000000,10000000,00000,,350000
The Hollywood Knights,10000000,10000000,00000,,00000
Margie,10000000,10000000,00000,,00000
Hankyu Dentetsu,9998665,00000,9998665,,00000
Return to Peyton Place,9996178,9996178,00000,,00000
Fanny,9996178,9996178,00000,,00000
The Deep End,9981635,8823109,1158526,,3000000
Dirty Work,9975684,9975684,00000,,13000000
A Family Thing,9974397,9974397,00000,,00000
Light of Day,9953193,9953193,00000,,00000
Lassie,9942954,9942954,00000,,00000
Brazil,9929135,9929135,00000,,15000000
Once Bitten,9917242,9917242,00000,,00000
Dialogue avec mon jardinier,9897351,93604,9803747,,00000
English Vinglish,9886679,1862086,8024593,,00000
Night Falls On Manhattan,9881286,9881286,00000,,00000
Explorers,9873000,9873000,00000,,00000
The Serial,9870727,9870727,00000,,00000
Maid to Order,9868000,9868000,00000,,00000
Murphy's Law,9866959,9866959,00000,,00000
Hitler Kaput!,9860147,00000,9860147,,00000
Elephant,9857377,1257377,8600000,,00000
The Black Stallion Returns,9851679,9851679,00000,,00000
Disorderlies,9832507,9832507,00000,,00000
Hanky Panky,9823934,9823934,00000,,00000
3 Strikes,9821335,9821335,00000,,4000000
Badrinath,9818936,00000,9818936,,00000
Dudley Do-Right,9818792,9818792,00000,,22000000
Jade,9812870,9812870,00000,,50000000
Gokaiger Goseiger Super Sentai 199 Hero Great Battle,9793837,00000,9793837,,00000
Paa,9791282,199228,9592054,,4300000
Serge Gainsbourg vie heroique,9765361,233007,9532354,,00000
Big Man Japan,9740796,40796,9700000,,00000
"New York, I Love You",9725060,1588087,8136973,,00000
Cloak & Dagger,9719952,9719952,00000,,00000
The Hole 3D,9716671,00000,9716671,,00000
Someone to Watch Over Me,9713059,9713059,00000,,00000
Chîmu bachisuta no eikô,9710761,00000,9710761,,00000
Somewhere in Time,9709597,9709597,00000,,5100000
Conquest of the Planet of the Apes,9700000,9700000,00000,,1700000
SpaceCamp,9697739,9697739,00000,,00000
Get Low,9696933,9176933,520000,4312393,7000000
Horst Schlammer - Isch Kandidiere!,9692564,00000,9692564,,00000
The Butcher's Wife,9689816,9689816,00000,,00000
"He Said, She Said",9684702,9684702,00000,,00000
Jerusalem,9681975,8020721,1661254,,00000
Simone,9680913,9680913,00000,,00000
Shall We Dance?,9676677,9676677,00000,,00000
Immortal Beloved,9673699,9673699,00000,,00000
The Express,9663628,9643725,19903,7664805,37500000
Winter in Wartime,9662214,542860,9119354,,5800000
Miami Blues,9654290,9654290,00000,,00000
A Rage in Harlem,9649208,9649208,00000,,00000
Young Black Stallion,9638389,6751389,2887000,,00000
Without a Trace,9632062,9632062,00000,,00000
Belly,9630169,9630169,00000,,00000
The Swan Princess,9618296,9618296,00000,,00000
Me and You and Everyone We Know,9615464,3885134,5730330,,2000000
Come tu mi vuoi,9612073,00000,9612073,,00000
Wrongfully Accused,9604029,9604029,00000,,00000
Pepe,9600000,9600000,00000,,00000
On the Waterfront,9600000,9600000,00000,,910000
The Gods Must be Crazy II,9591444,6291444,3300000,,00000
Chashme Baddoor,9587945,235401,9352544,,00000
The Dark Half,9579068,9579068,00000,,15000000
The Baby-Sitters Club,9574155,9574155,00000,,00000
Guzaarish,9573725,1026589,8547136,,00000
Monsieur Ibrahim,9564199,2824365,6739834,,00000
Scenes from a Mall,9563393,9563393,00000,,00000
Breakfast at Tiffany's,9551904,9551904,00000,,00000
The Man with Two Brains,9535225,9535225,00000,,00000
Shade,9533964,25032,9508932,,6800000
All the King's Men,9521458,7221458,2300000,,55000000
From the Hip,9518342,9518342,00000,,00000
Open Season 2,9510171,00000,9510171,28612970,00000
Thirteen,9505996,4601043,4904953,,2000000
Red Rock West,9502551,2502551,7000000,,00000
Flesh and Bone,9488998,9488998,00000,,00000
Parlami d'amore,9482854,00000,9482854,,00000
Arrancame la Vida,9475906,00000,9475906,,00000
Mr. Perfect,9472240,00000,9472240,,00000
The Journey of Natty Gann,9468512,9468512,00000,,00000
Hercules,9466655,9466655,00000,,00000
Sleeping Beauty,9464608,9464608,00000,,00000
Amos & Andrew,9461630,9461630,00000,,00000
Captivity,9459740,2686800,6772940,4066341,00000
Ahora o nunca,9456067,00000,9456067,,00000
The Wild Life,9453750,9453750,00000,,00000
The Libertine,9448623,4835065,4613558,2845389,22000000
Belka i Strelka. Zvezdnye sobaki,9445081,00000,9445081,,25000000
Ta Ra Rum Pum,9443864,872643,8571221,,7400000
Criminal Law,9443550,9443550,00000,,00000
Viva Las Vegas,9442967,9442967,00000,,00000
Veronica Guerin,9438074,1569918,7868156,,17000000
We Are Your Friends,9417474,3591417,5826057,,2000000
Secretary,9413956,4046737,5367219,,4000000
Sleepover,9408183,9408183,00000,,10000000
The Station Agent,9408027,5739376,3668651,,500000
The Brink's Job,9400000,9400000,00000,,00000
Dunston Checks In,9395724,9395724,00000,,00000
Kidnapping Granny K,9386541,00000,9386541,,00000
So Fine,9381808,9381808,00000,,00000
Stoker,9379873,1703125,7676748,,12000000
Guilty by Suspicion,9379048,9379048,00000,,00000
Ernest et Celestine,9376444,292562,9083882,150710,12500000
Death Bell,9370310,00000,9370310,,00000
Tuff Turf,9369329,9369329,00000,,00000
Super Babies: Baby Geniuses 2,9355369,9109322,246047,,20000000
The Martian Child,9352089,7500310,1851779,7795281,27000000
"Grande Seduction, La",9351407,9351407,00000,,00000
Kissing Jessica Stein,9345061,7025722,2319339,,1500000
Salvando al Soldado Perez,9330465,1400726,7929739,,4500000
Hellraiser IV: Bloodline,9321492,9321492,00000,,00000
Il 7 E L'8,9321290,00000,9321290,,00000
We're Back! A Dinosaur's Story,9315576,9315576,00000,,00000
Mad Hot Ballroom,9315135,8045515,1269620,,500000
Open Season 3,9312631,00000,9312631,12259433,00000
La nouvelle guerre des boutons,9309554,45602,9263952,,00000
Peeples,9307166,9177065,130101,2637886,15000000
Black House,9306547,00000,9306547,,00000
Promised Land,9300336,7597898,1702438,3040346,15000000
Bobby Deerfield,9300000,9300000,00000,,00000
Serbuan maut,9297407,4105123,5192284,3272802,1100000
Chaplin,9289349,9289349,00000,,00000
Salaam Namaste,9287721,1411065,7876656,,00000
Stone Cold,9286314,9286314,00000,,25000000
Lost in Yonkers,9285189,9285189,00000,,00000
On the Road,9264551,720828,8543723,801418,25000000
Le nom des gens,9261711,514237,8747474,,4600000
Angie,9252349,9252349,00000,,00000
Lolita,9250000,9250000,00000,,2000000
Jerry Springer: Ringmaster,9247881,9247881,00000,,00000
Bon Voyage!,9230769,9230769,00000,,00000
The Interns,9230769,9230769,00000,,00000
A bout portant,9230157,708215,8521942,,00000
Mrs. Brown,9217930,9217930,00000,,00000
Everybody's Fine,9208876,9208876,00000,7440072,20000000
Mon meilleur ami,9205935,1422461,7783474,,00000
Return of the Living Dead Part II,9205924,9205924,00000,,6200000
Fierce Creatures,9202671,9202671,00000,,00000
Havana,9200339,9200339,00000,,00000
Dirt,9200000,9200000,00000,,00000
The Four Horsemen of the Apocalypse,9200000,9200000,00000,,00000
Deux jours à tuer,9196127,00000,9196127,,00000
Bad Boys,9190819,9190819,00000,,00000
The Hidden,9188867,9188867,00000,,00000
State and Main,9182500,6920692,2261808,,00000
Boom Town,9172000,9172000,00000,,2000000
Hairspray,9171108,6671108,2500000,,00000
What's Eating Gilbert Grape,9170214,9170214,00000,,11000000
Celtic Pride,9169981,9169981,00000,,00000
Becket,9164370,9164370,00000,,00000
Dr. Strangelove,9164370,9164370,00000,,1800000
Evangerion shin gekijôban: Jo,9142563,107797,9034766,,00000
Dead Ringers,9134733,9134733,00000,,00000
The Valley of Decision,9132000,9132000,00000,,2160000
Send Me No Flowers,9129247,9129247,00000,,00000
Tap,9114702,9114702,00000,,00000
Miracle at St. Anna,9110458,7916887,1193571,10107522,45000000
Unfinished Song,9109857,1698952,7410905,,00000
Mientras duermes,9109597,00000,9109597,,5000000
Fantasia 2000 (Theatrical Release),9103630,9103630,00000,,80000000
Sweet Dreams,9085049,9085049,00000,,00000
Metallica Through the Never,9082906,3419967,5662939,197942,18000000
A Midsummer Night's Sex Comedy,9077269,9077269,00000,,00000
Me and Earl and the Dying Girl,9076014,6758416,2317598,,00000
Good Neighbor Sam,9072726,9072726,00000,,00000
Brave Story,9069428,00000,9069428,,00000
Le premier jour du reste de ta vie,9046096,00000,9046096,,00000
Target,9023199,9023199,00000,,00000
Trippin',9017070,9017070,00000,,3000000
Renegades,9015164,9015164,00000,,00000
Red River,9012000,9012000,00000,,3000000
White Sands,9011574,9011574,00000,,00000
Prince of the City,9000000,9000000,00000,,00000
The Conqueror,9000000,9000000,00000,,00000
Bad Dreams,9000000,9000000,00000,,00000
Beyond the Valley of the Dolls,9000000,9000000,00000,,1000000
Love Me Tender,9000000,9000000,00000,,1000000
The Inn of the Sixth Hapiness,9000000,9000000,00000,,00000
Zorba the Greek,9000000,9000000,00000,,00000
Mr. Smith Goes To Washington,9000000,9000000,00000,,1500000
Ben-Hur,9000000,9000000,00000,,3900000
Tribute,9000000,9000000,00000,,00000
Doctor Dolittle,9000000,9000000,00000,,00000
Saturn 3,9000000,9000000,00000,,00000
Tom Horn,9000000,9000000,00000,,00000
Switching Channels,9000000,9000000,00000,,00000
A Tree Grows in Brooklyn,9000000,9000000,00000,,00000
Wizards,9000000,9000000,00000,,00000
Desiree,9000000,9000000,00000,,00000
Vera Cruz,9000000,9000000,00000,,00000
Deadly Friend,8988731,8988731,00000,,00000
Cube,8969065,489220,8479845,,250000
Fatal,8929413,00000,8929413,,00000
Matinee,8925775,8925775,00000,,00000
Brainstorm,8921050,8921050,00000,,15000000
Wonderful World of the Brothers Grimm,8920615,8920615,00000,,00000
Bolero,8914881,8914881,00000,,00000
Teaching Mrs. Tingle,8910377,8910377,00000,,00000
Sunny,8909089,00000,8909089,,00000
Control,8902141,871577,8030564,,6400000
Cat's Eye,8899323,8899323,00000,,00000
The Formula,8894289,8894289,00000,,00000
DeathStalker,8890685,8890685,00000,,00000
Honey 2,8889625,00000,8889625,,00000
"Mystery, Alaska",8888143,8888143,00000,,28000000
The Inkwell,8864699,8864699,00000,,8000000
Gegege no Kitaro: Sennen Noroi Uta,8864234,00000,8864234,,00000
Hard To Hold,8853155,8853155,00000,,00000
Barney's Version,8845575,7502560,1343015,,30000000
The Return,8844785,7744785,1100000,,00000
Rob-B-Hood,8839526,00000,8839526,,00000
Apt Pupil,8838938,8838938,00000,,00000
Warlock,8824553,8824553,00000,,7000000
Gotcha,8823269,8823269,00000,,00000
The River,8818672,8818672,00000,,00000
Kinky Boots,8818428,1822428,6996000,,00000
Battery,8808213,00000,8808213,,00000
Body Double,8801940,8801940,00000,,10000000
The Hucksters,8800000,8800000,00000,,00000
Scandal,8800000,8800000,00000,,00000
Battle for the Planet of the Apes,8800000,8800000,00000,,1800000
The Green Inferno,8787893,7192291,1595602,,1000000
Banlieue 13: Ultimatum,8786375,36136,8750239,,00000
Ruby Sparks,8782978,2540106,6242872,,00000
The Rocker,8767338,6409528,2357810,9247772,15000000
The Game,8758154,00000,8758154,,00000
White Fang 2: Myth of the White Wolf,8752399,8752399,00000,,00000
The Pride and the Passion,8750000,8750000,00000,,00000
To Catch a Thief,8750000,8750000,00000,,00000
The Bachelor and the Bobby-Soxer,8750000,8750000,00000,,00000
Ghost World,8744515,6200756,2543759,,5500000
True Believer,8742000,8742000,00000,,00000
This is England,8739576,327919,8411657,,2380000
Delta Farce,8735908,8130530,605378,24214815,00000
Whatever it Takes,8735529,8735529,00000,,15000000
Yang Shan Zhou,8734350,00000,8734350,,00000
Kureyon Shinchan: bakauma_ B-ky_ gurume sabaibaru!!,8713735,00000,8713735,,00000
Suspect Zero,8712564,8712564,00000,,27000000
Running With Scissors,8706701,6860000,1846701,1877732,12000000
If You Could See What I Hear,8693512,8693512,00000,,00000
Inherent Vice,8692898,8110975,581923,734438,20000000
Baruto No Gakuen,8686010,00000,8686010,,00000
American Splendor,8685632,6003587,2682045,,2000000
Clean and Sober,8674093,8674093,00000,,00000
In the Mouth of Madness,8671748,8671748,00000,,00000
Once Upon a Crime…,8669847,8669847,00000,,00000
The Climber's High,8667202,00000,8667202,,00000
Seuls two,8659809,00000,8659809,,00000
The Machinist,8655397,1082044,7573353,,5000000
The Man With One Red Shoe,8645411,8645411,00000,,00000
Late for Dinner,8641499,8641499,00000,,00000
Village of the Damned,8635520,8635520,00000,,00000
That Was Then… This is Now,8630068,8630068,00000,,00000
MacGruber,8629895,8525600,104295,4760028,10000000
My iz budushego,8623914,00000,8623914,,00000
Secret Admirer,8622757,8622757,00000,,00000
Shaandaar,8621794,521794,8100000,,00000
Manhunter,8620929,8620929,00000,,00000
Before and After,8619397,8619397,00000,,00000
"Three Investigators and the Secret of Skeleton Island, The",8618118,00000,8618118,,00000
The Bounty,8613462,8613462,00000,,00000
How She Move,8607815,7070641,1537174,,17000000
The Year of Living Dangerously,8601065,8601065,00000,,00000
U2: Rattle and Hum,8600823,8600823,00000,,00000
Xinhai geming,8593154,135739,8457415,,30000000
De battre mon coeur s'est arrêté,8589831,1023424,7566407,,5500000
The Puppet Masters,8579626,8579626,00000,,00000
High Spirits,8578231,8578231,00000,,00000
Saturno Contro,8569001,00000,8569001,,00000
Happiness,8567220,00000,8567220,,00000
Blue Velvet,8551228,8551228,00000,,00000
Peepli Live,8544969,754836,7790133,,00000
Care Bears Movie II: A New Generation,8540346,8540346,00000,,00000
Albert Nobbs,8539003,3014696,5524307,,7500000
The Rich Man's Wife,8538318,8538318,00000,,00000
Mausam,8536942,725966,7810976,,00000
Leprechaun,8533294,8533294,00000,,00000
Oxford Blues,8531117,8531117,00000,,00000
The Big Brawl,8527743,8527743,00000,,00000
The Warrior's Way,8514325,5666340,2847985,3377997,42000000
Before Night Falls,8503459,4221817,4281642,,00000
All Dogs Go To Heaven 2,8499581,8499581,00000,,00000
Unstoppable Marriage,8491265,00000,8491265,,00000
Big Trouble,8488871,7262288,1226583,,45000000
Mischief,8483643,8483643,00000,,00000
Nothing But Trouble,8479793,8479793,00000,,00000
Wise Guys,8475466,8475466,00000,,00000
Zuì ài,8463200,00000,8463200,,00000
Le tout nouveau testament,8461624,00000,8461624,,00000
Les invasions barbares,8460000,8460000,00000,,5000000
Casa de mi Padre,8446952,5909483,2537469,3524710,6000000
Tender Mercies,8443124,8443124,00000,,00000
John Carpenter's Ghosts of Mars,8434601,8434601,00000,,28000000
Play it to the Bone,8427204,8427204,00000,,24000000
The Awakening,8415112,8415112,00000,,00000
Pushing Tin,8408835,8408835,00000,,33000000
Pinky,8400000,8400000,00000,,00000
Carbon Copy,8400000,8400000,00000,,00000
Meteor,8400000,8400000,00000,,16000000
All About Eve,8400000,8400000,00000,,00000
Body Parts,8398855,8398855,00000,,00000
The Collection,8396077,6810754,1585323,2398078,10000000
Country,8390574,8390574,00000,,00000
Love Me If You Dare,8387030,548707,7838323,,00000
Bones,8378853,7316658,1062195,,10000000
The Importance of Being Earnest,8378141,8378141,00000,,15000000
Grindhouse - Planet Terror,8374592,00000,8374592,,00000
Death to Smoochy,8374062,8355815,18247,,50000000
The Last Temptation of Christ,8373585,8373585,00000,,7000000
Jhoom Barabar Jhoom,8370665,695156,7675509,,00000
Nineteen Eighty-Four,8368371,8368371,00000,,00000
Something Wild,8362000,8362000,00000,,00000
Bon Voyage,8361736,2353728,6008008,,20000000
Yves St. Laurent,8360096,97092,8263004,,00000
Masked Rider Den-o,8353721,00000,8353721,,00000
Running Scared,8345277,6855137,1490140,,17000000
Mitt liv som hund,8345266,8345266,00000,,00000
Twin Dragons,8332431,8332431,00000,,00000
R.T.T.,8322166,00000,8322166,,00000
Asu Mare,8316282,00000,8316282,,00000
Terror in the Aisles,8316206,8316206,00000,,00000
Bug,8302995,7006708,1296287,2589587,4000000
Mr. Jones,8302752,8302752,00000,,00000
Chasing Mavericks,8300821,6002756,2298065,3224638,20000000
Beyond the Sea,8292914,6144806,2148108,,24000000
Larger Than Life,8289972,8289972,00000,,00000
Return to Paradise,8288513,8288513,00000,,00000
Bébé's Kids,8284881,8284881,00000,,00000
Proof,8284331,7535331,749000,9286344,20000000
Shadow of the Vampire,8279017,8279017,00000,,8000000
The Love Letter,8276228,8276228,00000,,15000000
Hard Candy,8267066,1024640,7242426,,950000
Lubov Morkov 3,8264969,00000,8264969,,00000
Tong que tai,8264881,00000,8264881,,00000
Alan Partridge,8253426,153426,8100000,90759,00000
Satisfaction,8253123,8253123,00000,,00000
Christopher Columbus: The Discovery,8251071,8251071,00000,,00000
The Blob,8247943,8247943,00000,,00000
White Noise 2: The Light,8243567,00000,8243567,,10000000
Tall Tale,8236432,8236432,00000,,00000
Hoot,8224998,8117637,107361,11257288,15000000
The Children of Huang Shi,8221700,1031872,7189828,,20000000
Black Robe,8211952,8211952,00000,,00000
La véritable histoire du Chat Botté,8208594,00000,8208594,,25000000
Gladiator,8205703,8205703,00000,,00000
Hondo,8200000,8200000,00000,,00000
The Misfits,8200000,8200000,00000,,4000000
McCabe & Mrs. Miller,8200000,8200000,00000,,00000
Lucas,8200000,8200000,00000,,00000
Sardaar Ji,8200000,00000,8200000,,2700000
Shoot Out at Lokhandwala,8191079,289232,7901847,,00000
The House on Sorority Row,8184633,8184633,00000,,00000
City Island,8173239,6671036,1502203,2290312,6000000
Underground Rendez-vous,8165482,00000,8165482,,00000
Bad Lieutenant: Port of Call New Orleans,8162545,1702112,6460433,5273539,25000000
Cadillac Records,8138000,8138000,00000,11845214,12000000
Code Name: The Cleaner,8135024,8135024,00000,7536479,20000000
Alone in the Dark,8132655,5132655,3000000,,20000000
Birthday Girl,8130727,4919896,3210831,,13000000
Funny About Love,8128773,8128773,00000,,00000
The Rising,8127331,939363,7187968,,00000
BLUE,8125973,321640,7804333,,00000
Key Largo,8125000,8125000,00000,,00000
Days of Wine and Roses,8123077,8123077,00000,,00000
Things We Lost in the Fire,8120148,3287315,4832833,3105909,16000000
A Simple Wish,8119205,8119205,00000,,28000000
Turbo: A Power Rangers Movie,8109349,8109349,00000,,00000
The Philadelphia Experiment,8103330,8103330,00000,,00000
Après vous...,8100941,826220,7274721,,00000
Shoot the Moon,8100000,8100000,00000,,00000
More American Graffiti,8100000,8100000,00000,,00000
Fresh,8094616,8094616,00000,,00000
L'auberge rouge,8084371,50304,8034067,,00000
Animal Kingdom,8078683,1044039,7034644,,4200000
Nick of Time,8053256,8053256,00000,,00000
Le passe,8049907,1335672,6714235,,00000
Veer,8049862,527193,7522669,,00000
Connie & Carla,8047525,8047525,00000,,20000000
Firestorm,8041665,8041665,00000,,19000000
The Adventures of Baron Munchausen,8040008,8040008,00000,,00000
Sommer,8034431,00000,8034431,,00000
Dhoom 3,8031955,8031955,00000,,00000
Woo,8026971,8026971,00000,,13000000
The Texas Chainsaw Massacre 2,8025872,8025872,00000,,4700000
Once Upon a Time in Korea,8022157,00000,8022157,,00000
The Meteor Man,8015592,8015592,00000,,00000
No Problem,8015159,285468,7729691,,00000
Bingo,8011019,8011019,00000,,00000
"20,000 Leagues Under the Sea",8000000,8000000,00000,,200000
The Taming of the Shrew,8000000,8000000,00000,,00000
The Agony and the Ecstasy,8000000,8000000,00000,,00000
High Noon,8000000,8000000,00000,,730000
Love Me or Leave Me,8000000,8000000,00000,,00000
The Three Musketeers,8000000,8000000,00000,,00000
Salsa,8000000,8000000,00000,,00000
Sweet Charity,8000000,8000000,00000,,20000000
Annie Get Your Gun,8000000,8000000,00000,,3768785
The Undefeated,8000000,8000000,00000,,00000
King of the Gypsies,8000000,8000000,00000,,00000
Casey's Shadow,8000000,8000000,00000,,00000
The Man Who Shot Liberty Valance,8000000,8000000,00000,,3200000
Indiscreet,8000000,8000000,00000,,00000
A Streetcar Named Desire,8000000,8000000,00000,,1800000
Robin and Marian,8000000,8000000,00000,,5000000
Ski Patrol,8000000,8000000,00000,,00000
Terror Train,8000000,8000000,00000,,3500000
Island in the Sun,8000000,8000000,00000,,00000
Paradise Alley,8000000,8000000,00000,,00000
Islands in the Stream,8000000,8000000,00000,,00000
Come to the Stable,8000000,8000000,00000,,00000
Without a Clue,8000000,8000000,00000,,00000
Do Not Disturb,8000000,8000000,00000,,00000
Nightbreed,8000000,8000000,00000,,00000
Rooster Cogburn,8000000,8000000,00000,,00000
Force: Five,8000000,8000000,00000,,00000
The Devil's Brigade,8000000,8000000,00000,,00000
Cat People,8000000,4000000,4000000,,134000
Where Were You When the Lights Went Out?,7988000,7988000,00000,,00000
My Giant,7985929,7985929,00000,,00000
The Pirate Movie,7983086,7983086,00000,,00000
Tanu Weds Manu,7976388,240020,7736368,,00000
Impostor,7974607,6114237,1860370,,40000000
Alles is Liefde,7966048,00000,7966048,,00000
Irreversible,7960855,792200,7168655,,00000
The Sweet Hereafter,7951247,4306697,3644550,,5000000
Dazed and Confused,7950889,7950889,00000,,6900000
Naruto Shippuden: The Movie,7947209,00000,7947209,,00000
Kurbaan,7938155,754269,7183886,,00000
La Matassa,7937165,00000,7937165,,00000
Dai-Nipponjin,7928615,23446,7905169,,00000
A Thousand Acres,7928412,7928412,00000,,00000
All the Best: Fun Begins,7925046,120713,7804333,,00000
Hwang Jin-yi,7923851,00000,7923851,,00000
La fille coupée en deux,7909658,409658,7500000,,00000
Strange Days,7907619,7907619,00000,,00000
The Ark of Mr. Chow,7903252,53252,7850000,,00000
The Alamo,7900000,7900000,00000,,12000000
Unstrung Heroes,7894330,7894330,00000,,00000
Pulling Strings,7891478,5842961,2048517,,00000
Teen Wolf Too,7888000,7888000,00000,,3000000
Cheetah,7882250,7882250,00000,,00000
Serial Mom,7881335,7881335,00000,,13000000
Revolver,7880568,84738,7795830,,00000
Bunty Aur Babli,7876721,932509,6944212,,00000
Lassie,7875911,652163,7223748,,00000
The Clearing,7863875,5763875,2100000,,00000
Cedar Rapids,7862131,6861102,1001029,1530360,10000000
Mr. Turner,7847605,3958546,3889059,276884,00000
Aspen Extreme,7843388,7843388,00000,,00000
Bad Words,7843145,7779614,63531,1917563,10000000
Fatal Instinct,7839327,7839327,00000,,00000
Cheeni Kum,7837674,678792,7158882,,00000
Un Nonio Para Mi Mujer,7836499,00000,7836499,,00000
The Chase,7836488,7836488,00000,,00000
Manuale D'Amore 3,7829947,00000,7829947,,00000
The Little Drummer Girl,7828841,7828841,00000,,00000
Little Boy,7826546,6485961,1340585,1144244,20000000
Outside Providence,7824358,7309628,514730,,7000000
Venus,7818479,3347411,4471068,,6000000
Reonningmaen,7818402,00000,7818402,,00000
Desi Boyz,7812311,1066167,6746144,,00000
Tupac Resurrection,7808524,7718961,89563,,300000
Sands of Iwo Jima,7800000,7800000,00000,,1000000
Gentleman's Agreement,7800000,7800000,00000,,2000000
All Night Long,7800000,7800000,00000,,00000
House II: The Second Story,7800000,7800000,00000,,00000
Inside Job,7799257,4311834,3487423,6612980,2000000
Moshi K_k_ Yaky_ no Joshi Manager ga Drucker no Management o Yondara,7797606,00000,7797606,,00000
Little Buddha,7793587,4793587,3000000,,00000
Vampire Academy,7791979,7791979,00000,3215537,00000
The Best of Times,7790931,7790931,00000,,00000
In the Loop,7788804,2388804,5400000,,00000
Nowhere Boy,7785229,1445366,6339863,,1900000
If Looks Could Kill,7781025,7781025,00000,,00000
Real Women Have Curves,7777790,5853194,1924596,,3000000
Hoshi Mamoru Inu,7772082,00000,7772082,,00000
Sirens,7770731,7770731,00000,,00000
Smoke Signals,7756617,6719300,1037317,,2000000
Seeking a Friend for the End of the World,7756163,7078738,677425,1631191,10000000
DOA: Dead or Alive,7755686,480314,7275372,2747274,30000000
Oddball,7752963,00000,7752963,,00000
The Great White Hype,7751497,7751497,00000,,00000
I Was a Male War Bride,7750000,7750000,00000,,00000
Small Town Rivals,7741557,00000,7741557,,00000
Cry-Baby,7735790,7735790,00000,,00000
The Hunting Party,7729552,876671,6852881,3385090,40000000
Deepstar Six,7724847,7724847,00000,,00000
Finding Fanny,7723229,623229,7100000,,00000
A New Life,7721851,7721851,00000,,00000
The Manchurian Candidate,7716923,7716923,00000,,00000
Kevin Hart: Laugh at My Pain,7712436,7706436,06000,5029690,750000
Blue Steel,7701707,7701707,00000,,00000
Wake Up Sid,7691919,718766,6973153,,00000
Surviving the Game,7690013,7690013,00000,,00000
Runaway Train,7683620,7683620,00000,,00000
Strictly Business,7683267,7683267,00000,,00000
Twice in a Lifetime,7681246,7681246,00000,,00000
We Are Family,7678147,638144,7040003,,00000
Parlez-moi de la pluie,7676474,111844,7564630,,00000
Mo jing,7672010,172010,7500000,,00000
Bao Chi Tong Hua,7635579,00000,7635579,,00000
Young @ Heart,7623756,3966690,3657066,,00000
La mujer de mi hermano,7622028,2808241,4813787,,00000
Ninja III: The Domination,7610785,7610785,00000,,00000
Les Lyonnais,7600383,00000,7600383,,00000
The Quiet Man,7600000,7600000,00000,,00000
The Hustler,7600000,7600000,00000,,2000000
The Spy Who Came in from the Cold,7600000,7600000,00000,,00000
Expelled: No Intelligence Allowed,7598071,7598071,00000,5969084,00000
Enemies: A Love Story,7592396,7592396,00000,,00000
Paper Planes,7590057,00000,7590057,32330,00000
Ong-Bak 2,7583050,102458,7480592,2617120,15000000
Take Me Home Tonight,7576604,6928068,648536,3182721,19000000
Club Dread,7573551,5001655,2571896,,8500000
El Cantante,7556004,7556004,00000,10734174,00000
The Jerky Boys,7555256,7555256,00000,,4000000
Sprung,7553105,7553105,00000,,00000
Losing Isaiah,7551247,7551247,00000,,00000
Mortadelo y Filemón. Misión: Salvar la Tierra,7541906,00000,7541906,,00000
Dr. Giggles,7534285,7534285,00000,,00000
Damage,7532911,7532911,00000,,00000
Nothing Like the Holidays,7519490,7503736,15754,3585479,00000
Just the Way You Are,7517699,7517699,00000,,00000
Krippendorf's Tribe,7514883,7514883,00000,,00000
Tashan,7512447,457380,7055067,,00000
Our Brand is Crisis,7505015,6957727,547288,,28000000
Danny Collins,7501132,5637066,1864066,,10000000
The Cowboys,7500000,7500000,00000,,00000
Walk Don't Run,7500000,7500000,00000,,00000
Big Jake,7500000,7500000,00000,,00000
How to Beat the High Co$t of Living,7500000,7500000,00000,,00000
Night and Day,7500000,7500000,00000,,00000
Agatha,7500000,7500000,00000,,00000
An Eye for an Eye,7496681,7496681,00000,,00000
The Amazing Panda Adventure,7491904,7491904,00000,,00000
The Babadook,7482387,950792,6531595,904402,00000
Hackers,7479498,7479498,00000,,00000
Kidnap,7471988,328573,7143415,,00000
Foxes,7470348,7470348,00000,,00000
Stealing Home,7467504,7467504,00000,,00000
The Trip to Bountiful,7466662,7466662,00000,,00000
My Old Lady,7465741,4011530,3454211,759416,00000
Spellbound,7457710,5728581,1729129,,00000
I'll See You in My Dreams,7449681,7449681,00000,,00000
5&times;2,7428752,128752,7300000,,00000
2 Days in New York,7418672,633210,6785462,,00000
London Dreams,7418282,300293,7117989,,00000
"The Cook, The Thief, His Wife, and Her Lover",7407995,7407995,00000,,00000
A Scanner Darkly,7405084,5501616,1903468,,20000000
Midnight Lace,7400000,7400000,00000,,00000
Separate Tables,7400000,7400000,00000,,00000
Blankman,7395486,7395486,00000,,00000
Ironweed,7393346,7393346,00000,,00000
Bizan,7391563,00000,7391563,,00000
Requiem for a Dream,7390108,3635482,3754626,,4500000
La princesse de Montpensier,7384313,344245,7040068,,00000
Marguerite,7378046,00000,7378046,,00000
It Runs in the Family,7375836,7375836,00000,,00000
Funny Games,7371853,1294640,6077213,,00000
The Condemned,7371706,7371706,00000,23119685,00000
Witchboard,7369373,7369373,00000,,2000000
Only You,7361565,61565,7300000,,00000
Bushwhacked,7357794,7357794,00000,,00000
Clean Slate,7352116,7352116,00000,,00000
Haunted Honeymoon,7348798,7348798,00000,,00000
Clifford,7347669,7347669,00000,,00000
Iceman,7343032,7343032,00000,,00000
The Way Back,7341318,2719296,4622022,,00000
The Crucible,7340103,7340103,00000,,00000
Eiga: Kurosagi,7336788,00000,7336788,,00000
Alice,7331647,7331647,00000,,00000
Wild America,7324662,7324662,00000,,00000
Mississippi Masala,7308786,7308786,00000,,00000
Sarafina!,7306242,7306242,00000,,00000
Who's That Girl?,7305000,7305000,00000,,00000
Donnie Darko,7301393,1270522,6030871,,4500000
Phat Girlz,7301115,7061128,239987,18697721,3000000
How to Marry a Millionaire,7300000,7300000,00000,,00000
Thank God It's Friday,7300000,7300000,00000,,00000
Wild Hearts Can't Be Broken,7300000,7300000,00000,,00000
Gigi,7300000,7300000,00000,,00000
Respiro,7289413,1072534,6216879,,00000
Black Nativity,7285135,7018188,266947,39273,17500000
Shadows in the Palace,7284511,00000,7284511,,00000
Searching for Bobby Fischer,7266393,7266393,00000,,00000
"Prix a Payer, Le",7250992,00000,7250992,,00000
[Rec] 3: Genesis,7250600,09600,7241000,,00000
Kaminey,7249589,1286143,5963446,,00000
Quicksilver,7246979,7246979,00000,,00000
Off Limits,7242035,7242035,00000,,00000
Wo Zhi Nv Ren Xin,7241927,123527,7118400,,00000
Rush,7241350,7241350,00000,,00000
The Missionary,7241180,7241180,00000,,00000
B*A*P*S,7240837,7240837,00000,,00000
I Know Who Killed Me,7233485,7233485,00000,27849387,00000
Udon,7229481,00000,7229481,,00000
Barcelona,7224321,7224321,00000,,00000
Hanni und Nanni,7223509,00000,7223509,,00000
She's So Lovely,7221836,7221836,00000,,00000
Die kommenden Tage,7221324,00000,7221324,,00000
Under the Skin,7220721,2605039,4615682,1059923,13300000
Inu to watashi no 10 no yakusoku,7220517,00000,7220517,,00000
Disorganized Crime,7210149,7210149,00000,,00000
The Big Red One,7206220,7206220,00000,,00000
The Big Year,7204138,7204138,00000,5381510,41000000
Life Before Her Eyes,7203439,303439,6900000,,12000000
Bachna Ae Haseeno,7202166,702166,6500000,,00000
Singin' in the Rain,7200000,7200000,00000,,2540000
Tex,7199408,7199408,00000,,00000
Transylvania 6-5000,7196872,7196872,00000,,00000
Jalsa,7194096,00000,7194096,,00000
Troop Beverly Hills,7190505,7190505,00000,,18000000
Maximum Overdrive,7188513,7188513,00000,,00000
Zeus and Roxanne,7183046,7183046,00000,,00000
Mujeres al borde de un ataque de nervios,7179000,7179000,00000,,00000
The Boy Who Could Fly,7177431,7177431,00000,,00000
10 to Midnight,7175592,7175592,00000,,00000
Obsluhoval jsem anglického krále,7174984,617228,6557756,,4900000
The Hoax,7164995,7164995,00000,,25000000
Then She Found Me,7162920,3735717,3427203,,00000
The Name of the Rose,7153000,7153000,00000,,00000
Lorenzo's Oil,7144115,7144115,00000,,00000
Caos Calmo,7142222,11434,7130788,,00000
She's Gotta Have It,7137502,7137502,00000,,175000
Exit Through the Gift Shop,7132689,3291250,3841439,,00000
Confidences trop intimes,7117027,2106677,5010350,,00000
Dear God,7114089,7114089,00000,,00000
Gigli,7107195,6068735,1038460,,54000000
Phantom of the Opera at the Royal Albert Hall,7106631,00000,7106631,,00000
Where Eagles Dare,7100000,7100000,00000,,00000
Force 10 from Navarone,7100000,7100000,00000,,5000000
1492: Conquest of Paradise,7099531,7099531,00000,,00000
Kakushi toride no san akunin,7095183,00000,7095183,,00000
The Adventures of Pluto Nash,7094995,4411102,2683893,,100000000
Pride,7094650,7057600,37050,7154354,00000
Mr. & Mrs. Bridge,7094313,7094313,00000,,00000
The September Issue,7081682,3820700,3260982,,00000
Fuga de Cerebros 2,7080080,00000,7080080,,00000
Taras Bulba,7077312,00000,7077312,,00000
Journey to the South Pacific,7077276,7077276,00000,,00000
Croupier,7071143,6201143,870000,,00000
Lemon Tree,7069672,569672,6500000,,00000
The Stunt Man,7063886,7063886,00000,,00000
Tinker Bell and the Great Fairy Rescue,7043631,00000,7043631,47661753,00000
Hamlet,7043111,4414535,2628576,,18000000
Sin Nombre,7036422,2536665,4499757,,00000
The Adventures of Bob & Doug McKenzie: Strange Brew,7035618,7035618,00000,,00000
La Cara Oculta,7033931,00000,7033931,,2600000
Rescue Dawn,7031838,5484375,1547463,24889154,10000000
Hardbodies,7031405,7031405,00000,,00000
Eat Drink Man Woman,7028797,7028797,00000,,00000
Laaga Chunari Mein Daag,7025926,675102,6350824,,00000
Hiding Out,7019441,7019441,00000,,00000
Maybe Baby,7019147,19147,7000000,,00000
Goon,7018603,4164911,2853692,2389074,00000
Harley Davidson and the Marlboro Man,7018525,7018525,00000,,23000000
Veer-Zaara,7017859,2938532,4079327,,7000000
An American Carol,7017257,7008265,08992,,20000000
Star Kid,7015240,7015240,00000,,00000
Crossover,7009668,7009668,00000,6014474,5600000
The Five Heartbeats,7008492,7008492,00000,,00000
Bound,7007589,3798532,3209057,,4500000
Grandma,7006626,6881231,125395,,00000
The Funhouse,7000000,7000000,00000,,00000
Marnie,7000000,7000000,00000,,00000
Spellbound,7000000,7000000,00000,,1500000
The Great Santini,7000000,7000000,00000,,00000
The Sugarland Express,7000000,7000000,00000,,00000
Smokey and the Bandit III,7000000,7000000,00000,,00000
The Trouble With Harry,7000000,7000000,00000,,1200000
Garden of Evil,7000000,7000000,00000,,00000
Strangers on a Train,7000000,7000000,00000,,1200000
Raise the Titanic,7000000,7000000,00000,,40000000
The Fifth Floor,7000000,7000000,00000,,00000
Phantasm II,7000000,7000000,00000,,3000000
Eraserhead,7000000,7000000,00000,,100000
Fatso,7000000,7000000,00000,,00000
Topkapi,7000000,7000000,00000,,00000
The Prisoner of Zenda,7000000,7000000,00000,,12500000
I Want To Live!,7000000,7000000,00000,,00000
Wasabi,7000000,81525,6918475,,15300000
Arn - Riket vid vägens slut,6998907,00000,6998907,,00000
In Darkness,6994218,6994218,00000,,00000
Trail of the Pink Panther,6988928,6988928,00000,,00000
Relentless,6985999,6985999,00000,,00000
Last of the Dogmen,6983547,6983547,00000,,00000
Screwed,6982680,6982680,00000,,12000000
Innocent Voices,6982159,837878,6144281,,00000
Microcosmos,6973842,1573842,5400000,,00000
Trial by Jury,6971777,6971777,00000,,00000
Fearless,6971266,6971266,00000,,00000
I Ought to be in Pictures,6968359,6968359,00000,,00000
Klovn Forever,6965452,00000,6965452,,00000
Class of 1984,6965361,6965361,00000,,3250000
Stick,6964734,6964734,00000,,00000
Paragraf 78,6962393,00000,6962393,,00000
Shag,6957975,6957975,00000,,00000
Children of the Corn II: The Final Sacrifice,6953340,6953340,00000,,00000
Haunted 3-D,6952492,00000,6952492,,00000
Strange Wilderness,6947084,6575282,371802,10428391,20000000
L'heure d'été,6947001,1647001,5300000,,00000
Blue City,6947000,6947000,00000,,00000
Suna-dokei,6943948,00000,6943948,,00000
BASEketball,6940185,6940185,00000,,00000
Dead Bang,6935216,6935216,00000,,00000
The Wedding Banquet,6933000,6933000,00000,,00000
Rascals,6926289,261156,6665133,,00000
The Awakening,6924321,95933,6828388,,4900000
The Spectacular Now,6916951,6852971,63980,2122982,2500000
Trapped,6916869,6916869,00000,,30000000
Hagetaka,6915788,00000,6915788,,00000
Three Wishes,6913141,6913141,00000,,00000
Alphabet City,6912834,6912834,00000,,00000
The Apparition,6909667,4936819,1972848,,17000000
A Cry in the Dark,6908797,6908797,00000,,00000
Red Sonja,6905861,6905861,00000,,17900000
House Arrest,6895790,6895790,00000,,00000
Resturlaub,6883237,00000,6883237,,00000
Willard,6882696,6882696,00000,,20000000
Gekij_ban Naruto: Buraddo Purizun,6881888,00000,6881888,,00000
Redline,6881021,6881021,00000,5321407,00000
Woman Thou Art Loosed,6879730,6879730,00000,,3000000
200 Cigarettes,6851636,6851636,00000,,6000000
Un'Estate al mare,6845033,00000,6845033,,00000
Namastey London,6831069,1207007,5624062,,8400000
Moonlight Mile,6830957,6830957,00000,,21000000
Da Wu Sheng,6827074,35986,6791088,,00000
Never Talk to Strangers,6826471,6826471,00000,,00000
Exit to Eden,6813570,6813570,00000,,00000
Bran Nue Dae,6812530,113568,6698962,,6750000
Apocalypse Code,6811168,00000,6811168,,00000
Panther,6809227,6809227,00000,,00000
Carriers,6808883,104352,6704531,,00000
The Chipmunk Adventure,6804312,6804312,00000,,00000
The Train,6800000,6800000,00000,,5800000
Hang 'em High,6800000,6800000,00000,,1800000
Easter Parade,6800000,6800000,00000,,00000
Nos Jours Heureux,6793108,00000,6793108,,00000
Black and White,6789166,00000,6789166,,00000
Secret,6788688,00000,6788688,,00000
The Road Home,6780090,1280090,5500000,,00000
"Nie klam, kochanie",6773855,00000,6773855,,00000
Runaway,6770587,6770587,00000,,00000
A Mulher Invisível,6762276,00000,6762276,,00000
The Forsaken,6755271,6755271,00000,,5000000
Seraphin un Homme et Son,6749187,6749187,00000,,00000
Nie yin niang,6745638,545638,6200000,,15000000
Nine 1/2 Weeks,6734844,6734844,00000,,18000000
Caught Up,6731920,6724217,07703,,00000
Reckless,6731602,6731602,00000,,00000
De Storm,6730513,00000,6730513,,00000
Tamara Drewe,6727750,560391,6167359,,00000
Ali Baba ve 7 Cüceler,6727512,00000,6727512,,00000
Soosanghan Gogaekdeul,6720920,00000,6720920,,00000
Into the Night,6720160,6720160,00000,,00000
American History X,6712241,6712241,00000,,10000000
Hanni Und Nanni 3,6704690,00000,6704690,,00000
Comin' at Ya!,6704127,6704127,00000,,00000
The Aristocrats,6702420,6377277,325143,,00000
Till the Clouds Roll By,6700000,6700000,00000,,00000
The Mambo Kings,6698607,6698607,00000,,00000
Death Wish 4: The Crackdown,6694355,6694355,00000,,00000
U-Turn,6678249,6678249,00000,,00000
The Closet,6671454,6671454,00000,,00000
Nightmares,6670680,6670680,00000,,00000
Six Weeks,6668025,6668025,00000,,00000
Where the Buffalo Roam,6659377,6659377,00000,,00000
Swing Shift,6650206,6650206,00000,,00000
Un conte de No&euml;l,6648639,1060922,5587717,,00000
Apne,6643574,00000,6643574,,00000
Hanni und Nanni 2,6642831,00000,6642831,,00000
Fresh Horses,6640346,6640346,00000,,00000
Jannat,6634682,30316,6604366,,00000
Almost An Angel,6633976,6633976,00000,,00000
It's Kind of a Funny Story,6632950,6363628,269322,,8000000
The Big Bounce,6626115,6471394,154721,,50000000
Centurion,6623570,123570,6500000,4175515,15000000
Johnny Handsome,6622465,6622465,00000,,00000
The Gong Show Movie,6621520,6621520,00000,,00000
Swingers,6618578,4505922,2112656,,200000
Suburban Commando,6611326,6611326,00000,,00000
Mariages!,6609909,00000,6609909,,00000
The Golden Seal,6609870,6609870,00000,,00000
Mixed Nuts,6607387,6607387,00000,,00000
China: The Panda Adventure,6601743,3708478,2893265,,00000
It's a Wonderful Life,6600000,6600000,00000,60684701,3180000
Donovan's Reef,6600000,6600000,00000,,2686000
Grandma's Boy,6590172,6090172,500000,31990186,5000000
North,6583223,6583223,00000,,00000
I Capture the Castle,6574139,1174139,5400000,,00000
Gekijoban Kamen Raida Kiba Makaijo no O,6569478,00000,6569478,,00000
D.A.R.Y.L.,6561653,6561653,00000,,00000
Post Grad,6561243,6380019,181224,2337079,15000000
Trash,6553186,17484,6535702,,12000000
Lost and Found,6552255,6552255,00000,,14000000
The Razor's Edge,6551987,6551987,00000,,00000
Blood and Chocolate,6551310,3526588,3024722,8267183,15000000
Rough Cut,6547719,00000,6547719,,00000
Closed Circuit,6547526,5750995,796531,1734036,00000
I Dreamed of Africa,6543194,6543194,00000,,34000000
Lucky You,6521829,5755286,766543,2016703,55000000
Gunesi Gordum,6514227,00000,6514227,,00000
Bom yeoreum gaeul gyeoul geurigo bom,6502364,2380788,4121576,,00000
I'll Cry Tomorrow,6500000,6500000,00000,,00000
High Society,6500000,6500000,00000,,00000
The Osterman Weekend,6500000,6500000,00000,,00000
Last Woman Standing,6493017,163017,6330000,,00000
Teacher's Pet: The Movie,6491350,6491350,00000,,10000000
The Road to Wellville,6487257,6487257,00000,,00000
The Real McCoy,6484246,6484246,00000,,00000
Amy,6483425,07880,6475545,,00000
Switchback,6482195,6482195,00000,,38000000
Roger & Me,6477936,6477936,00000,,140000
Dead Calm,6477648,6477648,00000,,00000
Ferrari Ki Sawaari,6477036,420046,6056990,,00000
Flashback,6476134,6476134,00000,,00000
Star 80,6472990,6472990,00000,,00000
Black Moon Rising,6470565,6470565,00000,,00000
The Happy Life,6463745,00000,6463745,,00000
Mio Fratello è Figlio Unico,6463286,255620,6207666,,00000
The Good Thief,6460758,3517797,2942961,,30000000
Attack the Block,6459183,1024175,5435008,,13000000
The Last Unicorn,6455330,6455330,00000,,00000
Tu seras mon fils,6453531,203636,6249895,88836,00000
Twelve O'Clock High,6450000,6450000,00000,,00000
Warriors of Virtue,6448817,6448817,00000,,35000000
Waiting for Superman,6446066,6417135,28931,,00000
Pei an dong ni du guo man chang sui yue,6440456,119376,6321080,,00000
High Tension,6435262,3681066,2754196,,2850000
Against the Ropes,6429865,5881504,548361,,39000000
Feel the Noise,6423995,5867786,556209,2709276,00000
Il Divo,6420093,240159,6179934,,00000
The Temp,6419876,6419876,00000,,00000
Just Between Friends,6408791,6408791,00000,,00000
Goryeonghwa Gajok,6404951,00000,6404951,,00000
Nada SoSo,6402070,00000,6402070,,00000
My Own Private Idaho,6401336,6401336,00000,,2500000
Eyewitness,6400000,6400000,00000,,00000
Gods and Monsters,6390032,6390032,00000,,3500000
Battle for Terra,6387498,1647083,4740415,,00000
Cantinflas,6382924,6382924,00000,105142,00000
Transsiberian,6379575,2203641,4175934,,15000000
Defenseless,6379362,6379362,00000,,00000
The Hunted,6373305,6373305,00000,,00000
Ned Kelly,6371899,86959,6284940,,00000
P2,6348315,6348315,00000,4377499,00000
Changing Partners,6348194,00000,6348194,,00000
The Sting II,6347072,6347072,00000,,00000
L’écume des jours,6343235,303187,6040048,65819,00000
Motel Hell,6342668,6342668,00000,,00000
Before I Go to Sleep,6342457,3242457,3100000,925830,22000000
Pirates,6341825,1641825,4700000,,40000000
Amityville 3-D,6333135,6333135,00000,,00000
Joe Kidd,6330000,6330000,00000,,00000
Girls Just Want to Have Fun,6326051,6326051,00000,,00000
Deja Vu,6321997,821997,5500000,,00000
Little Miss Marker,6321392,6321392,00000,,00000
Most Wanted,6320276,6320276,00000,,00000
Affliction,6302154,6302154,00000,,00000
Faet,6301481,00000,6301481,,00000
Wen Tian,6301200,00000,6301200,,00000
A Sound of Thunder,6300451,1900451,4400000,,80000000
Alice's Restaurant,6300000,6300000,00000,,00000
Dil Bole Hadippa!,6296020,351457,5944563,,00000
Jab We Met,6295513,00000,6295513,,00000
What Planet Are You From?,6291602,6291602,00000,,50000000
Six Degrees of Separation,6284090,6284090,00000,,00000
Shi Quan Jiu Mei,6282049,00000,6282049,,00000
Article 99,6281089,6281089,00000,,00000
Contre-Enquete,6272554,11846,6260708,,00000
The Opposite of Sex,6267497,6267497,00000,,00000
Rambling Rose,6266621,6266621,00000,,00000
A Night in the Life of Jimmy Reardon,6264058,6264058,00000,,00000
Music Box,6263883,6263883,00000,,00000
Mambo Italiano (US Release),6250949,6250949,00000,,00000
Macbeth,6248454,00000,6248454,,00000
Deuces Wild,6244618,6044618,200000,,10000000
Widow's Peak,6243722,6243722,00000,,00000
Dick,6241697,6241697,00000,,13000000
Oldboy,6239723,707391,5532332,,3000000
45 Years,6231015,00000,6231015,,00000
Cave of Forgotten Dreams,6228171,5247347,980824,,00000
The Adventures of Buckaroo Banzai Across the 8th Dimension,6227998,6227998,00000,,00000
Harsh Times,6225304,3337931,2887373,6067113,2000000
Seer,6223500,00000,6223500,,00000
The House of the Spirits,6217413,6217413,00000,,00000
Oh Heavenly Dog,6216067,6216067,00000,,00000
Ils se marièrent et eurent beaucoup d'enfants (Happily Ever After),6204466,252341,5952125,,00000
Night and the City,6202756,6202756,00000,,00000
Topsy Turvy,6201757,6201757,00000,,20000000
Pennies from Heaven,6200000,6200000,00000,,00000
The Straight Story,6197866,6197866,00000,,10000000
Firstborn,6194621,6194621,00000,,00000
Las brujas de Zugarramurdi,6178357,00000,6178357,,00000
Nowhere in Africa,6173485,6173485,00000,,6500000
Do Knot Disturb,6173384,213525,5959859,,00000
Aisha,6165645,298431,5867214,,00000
Bel Ami,6165119,120462,6044657,,00000
UHF,6157157,6157157,00000,,5000000
Delta Force 2,6154944,6154944,00000,,00000
The Fifth Estate,6154172,3254172,2900000,1389030,26000000
Celebrity,6153836,5032496,1121340,,12000000
Chained Heat,6149983,6149983,00000,,00000
Banghwanghaneun Kalnel,6148888,00000,6148888,,00000
Mambo Italiano,6148823,3031801,3117022,,5500000
Mystery Date,6141446,6141446,00000,,00000
The Pope of Greenwich Village,6139896,6139896,00000,,00000
Horrid Henry: The Movie,6136575,00000,6136575,,00000
The Loft,6125192,6002684,122508,811744,00000
The Soldier,6123549,6123549,00000,,00000
The Border,6118683,6118683,00000,,13500000
Almost Heroes,6114928,6114928,00000,,00000
The Mighty,6113025,2643689,3469336,,100000
A Little Chaos,6112598,558173,5554425,,00000
London Boulevard,6111194,16075,6095119,,00000
Short Cuts,6110979,6110979,00000,,00000
Plenty,6104212,6104212,00000,,00000
The Door in the Floor,6102830,3835551,2267279,,00000
The Secret of Roan Inish,6101815,6101815,00000,,00000
Whose Life is it Anyway?,6100000,6100000,00000,,00000
"Il buono, il brutto, il cattivo",6100000,6100000,00000,,1200000
Dylan Dog: Dead of Night,6093725,1186538,4907187,1606744,20000000
Kull The Conqueror,6086891,6086891,00000,,00000
Vitus,6078568,186492,5892076,,00000
The Secret Life of Words,6076115,20678,6055437,,00000
Assassination,6075793,6075793,00000,,00000
A Good Woman,6075750,223144,5852606,,00000
Rosenstrasse,6073126,732036,5341090,,00000
A Most Violent Year,6071433,5749134,322299,620748,20000000
Heaven Help Us,6070794,6070794,00000,,00000
Learning to Drive,6059209,3447633,2611576,,00000
Men Don't Leave,6050018,6050018,00000,,00000
Megiddo: Omega Code 2,6047691,6047691,00000,,22000000
Meet the Mormons,6047363,6047363,00000,433380,00000
Best of the Best 2,6044652,6044652,00000,,00000
Kabei,6033130,14416,6018714,,00000
Ghost Dog: Way of the Samurai,6030230,3330230,2700000,,2000000
Frozen River,6030129,2511476,3518653,,1000000
The Limey,6030047,3193102,2836945,,10000000
A Fine Mess,6029824,6029824,00000,,00000
Foolish,6026908,6026908,00000,,1600000
La fille de Monaco,6016441,602992,5413449,,00000
Matru ki Bijlee ka Mandola,6009116,00000,6009116,,00000
Break Ke Baad,6004138,427628,5576510,,00000
The Truth About Charlie,6003000,5303000,700000,,00000
Trick or Treat,6000000,6000000,00000,,00000
Man's Favorite Sport?,6000000,6000000,00000,,00000
The Seven Year Itch,6000000,6000000,00000,,00000
The Unholy,6000000,6000000,00000,,00000
Dial M for Murder,6000000,6000000,00000,,00000
Thunder & Lightning,6000000,6000000,00000,,00000
Woman of the Year,6000000,6000000,00000,,00000
Topaz,6000000,6000000,00000,,4000000
The Shootist,6000000,6000000,00000,,00000
The War Wagon,6000000,6000000,00000,,00000
Wanted: Dead or Alive,6000000,6000000,00000,,00000
Claudine,6000000,6000000,00000,,00000
Captain Horatio Hornblower R.N.,6000000,6000000,00000,,00000
Mac and Me,6000000,6000000,00000,,00000
American Pop,6000000,6000000,00000,,00000
El Dorado,6000000,6000000,00000,,00000
Timerider: The Adventure of Lyle Swann,6000000,6000000,00000,,00000
"If It's Tuesday, This Must Be Belgium",6000000,6000000,00000,,00000
The Mountain Men,6000000,6000000,00000,,00000
How to Become a Detective,6000000,6000000,00000,,00000
The Fortune Cookie,6000000,6000000,00000,,00000
How to Succeed in Business Without Really Trying,6000000,6000000,00000,,00000
Hot to Trot,6000000,6000000,00000,,00000
Rebecca,6000000,6000000,00000,,1288000
Braddock: Missing in Action III,6000000,6000000,00000,,00000
Marjorie Morningstar,6000000,6000000,00000,,00000
Chisum,6000000,6000000,00000,,00000
The Grass is Greener,6000000,6000000,00000,,00000
Heartbeeps,6000000,6000000,00000,,10000000
The Group,6000000,6000000,00000,,00000
Apache,6000000,6000000,00000,,00000
Simon,6000000,6000000,00000,,00000
01969,5979011,5979011,00000,,00000
The Walking Dead,5975209,5975209,00000,,00000
Les Boys II,5974732,5974732,00000,,00000
Samsara,5966671,2672413,3294258,,4000000
Legendary Amazons,5959716,00000,5959716,,00000
My Little Pony: The Movie,5958456,5958456,00000,,00000
Dhan Dhana Dhan Goal,5957759,125547,5832212,,00000
La Première étoile,5955923,00000,5955923,,00000
Daikessen! Cho Urutora Hachi Kyodai,5954671,00000,5954671,,00000
The Return,5953886,501752,5452134,,15000000
Tantei Wa Bar Ni Iru 2,5951523,00000,5951523,,00000
Severance,5950002,137221,5812781,,10000000
Krazzy 4,5945182,487215,5457967,,00000
Dragonslayer,5939000,5939000,00000,,18000000
Mere Baap Pahle Aap,5937699,113576,5824123,,00000
Evil Dead II,5923044,5923044,00000,,3500000
Adulthood,5922805,00000,5922805,,00000
Fish Tank,5922292,374675,5547617,,3000000
The Touch,5918742,00000,5918742,,20000000
Folks!,5906300,5906300,00000,,00000
20 Feet From Stardom,5892466,4946250,946216,3407981,1000000
Milano-Palermo: il ritorno,5871643,00000,5871643,,00000
Light It Up,5871603,5871603,00000,,13000000
Vsyo Mogut Koroli,5858956,00000,5858956,,00000
Gang Related,5858599,5858599,00000,,00000
Last Dance,5857534,5857534,00000,,00000
The Rescue,5855392,5855392,00000,,00000
Inventing the Abbots,5852547,5852547,00000,,00000
The Transformers: The Movie,5849647,5849647,00000,14627069,00000
The Hitcher,5844868,5844868,00000,,00000
Immediate Family,5841286,5841286,00000,,00000
Palmetto,5840581,5840581,00000,,00000
Heaven & Earth,5840300,5840300,00000,,00000
Rabbit Hole,5839592,2229058,3610534,1620694,5000000
Crossroads,5839031,5839031,00000,,00000
Night of the Living Dead,5835247,5835247,00000,,4200000
The Last American Virgin,5829781,5829781,00000,,00000
Coco Chanel and Igor Stravinsky,5825982,1725982,4100000,,00000
Trapped in Paradise,5821500,5821500,00000,,00000
Stanley & Iris,5820015,5820015,00000,,00000
Intruders,5818427,48366,5770061,,00000
The Perfect Holiday,5812781,5812781,00000,7228612,00000
Jolly LLB,5801422,00000,5801422,,00000
Rio Bravo,5800000,5800000,00000,,00000
The Boxer,5799672,5799672,00000,,00000
Stritreysery,5799137,00000,5799137,,00000
The Skeleton Twins,5797192,5284309,512883,211264,1000000
The Feast of Love,5796467,3508572,2287895,,00000
Samba,5795336,151530,5643806,,00000
Mona Lisa,5794000,5794000,00000,,00000
Catch a Fire,5782198,4299773,1482425,,14000000
Sheena,5778353,5778353,00000,,25000000
Callas Forever,5773130,445996,5327134,,00000
Local Hero,5767363,5767363,00000,,00000
Heartbreak Hotel,5758778,00000,5758778,,00000
Ed Wood,5755976,5755976,00000,,18000000
Freche Mädchen,5752203,00000,5752203,,00000
Ishqiya,5749388,91468,5657920,,00000
Happiness,5746453,2746453,3000000,,3000000
Patiala House,5740505,644010,5096495,,00000
The Tie That Binds,5739486,5739486,00000,,00000
Gallipoli,5732587,5732587,00000,,3000000
Kolya,5730711,5730711,00000,,00000
Barton Fink,5726463,5726463,00000,,00000
Millennium,5725353,5725353,00000,,00000
El crimen de padre Amaro,5719000,5719000,00000,,1800000
One Eight Seven,5716080,5716080,00000,,00000
Wisdom,5715174,5715174,00000,,00000
Surrender,5711976,5711976,00000,,00000
Trolljegeren,5706638,253444,5453194,,3500000
Screamers,5701359,5701359,00000,,00000
"Sorry, Wrong Number",5700000,5700000,00000,,00000
Leatherface: Texas Chainsaw Massacre III,5697588,5697588,00000,,00000
Under Fire,5696391,5696391,00000,,00000
Who's Your Caddy?,5694308,5694308,00000,,7000000
People I Know,5694213,121972,5572241,,20000000
Blood: The Last Vampire,5683954,256682,5427272,1931958,00000
The Last Seduction,5682522,5682522,00000,,00000
Eight Men Out,5680515,5680515,00000,,00000
Megaforce,5675599,5675599,00000,,18000000
Gold Diggers: The Secret of Bear Mountain,5673570,5673570,00000,,00000
Nadine,5669831,5669831,00000,,00000
Heneral Luna,5665641,206040,5459601,,00000
The Concrete Jungle,5664557,5664557,00000,,00000
Down in the Delta,5662985,5662985,00000,,00000
Get on the Bus,5660056,5660056,00000,,2400000
Where the Money Is,5658940,5658940,00000,,00000
Last Cab to Darwin,5658101,00000,5658101,,00000
Phantoms,5657370,5657370,00000,,00000
Beyond Rangoon,5656641,5656641,00000,,00000
Something Wicked This Way Comes,5656087,5656087,00000,,00000
Underclassman,5654777,5654777,00000,,25000000
Hardware,5649801,5649801,00000,,00000
Never Die Alone,5644575,5644575,00000,,00000
Lump of Sugar,5641862,00000,5641862,,00000
Neues Vom Wixxer,5641431,00000,5641431,,00000
Monsters,5639730,237301,5402429,,500000
Swing Kids,5632086,5632086,00000,,00000
L'illusionniste,5631474,2231474,3400000,,17000000
College,5629618,4694491,935127,,6000000
Avenging Angel,5622787,5622787,00000,,00000
The Frozen Ground,5617460,00000,5617460,2374992,19200000
Batman: Mask of the Phantasm,5617391,5617391,00000,,00000
Man on Wire,5617067,2962242,2654825,,1900000
The Pallbearer,5612586,5612586,00000,,8000000
3D Sex and Zen: Extreme Ecstasy,5610901,152365,5458536,,00000
Timbuktu,5605501,1076075,4529426,48631,00000
Bbuddah: Hoga Tera Baap,5602704,326011,5276693,,00000
Yellow Sky,5600000,5600000,00000,,00000
Streets of Fire,5595150,5595150,00000,,00000
Tales from the Crypt Presents: Bordello of Blood,5587855,5587855,00000,,00000
The Cemetery Club,5583621,5583621,00000,,00000
Europa Europa,5575738,5575738,00000,,00000
"Ore wa, kimi no tame ni koso shini ni iku",5575613,00000,5575613,,00000
Cesar Chavez,5571497,5571497,00000,230176,00000
Vice Squad,5568880,5568880,00000,,00000
Walk of Shame,5565259,59209,5506050,125762,00000
A Night in Heaven,5563663,5563663,00000,,00000
Space Chimps 2: Zartog Strikes Back,5560200,00000,5560200,,00000
Nicotina,5559100,1109100,4450000,,00000
The Star Chamber,5555305,5555305,00000,,00000
The Lookout,5555018,4600585,954433,5236164,00000
For Your Consideration,5549923,5549923,00000,,12000000
Kundun,5532301,5532301,00000,,28000000
The Brothers Bloom,5531756,3531756,2000000,,20000000
Invisible Target,5520795,00000,5520795,,00000
Aqua Teen Hunger Force Colon Movie Film for Theaters,5520368,5520368,00000,12249791,750000
Wind,5519569,5519569,00000,,00000
Say It Isn't So,5516708,5516708,00000,,25000000
Cash,5512027,00000,5512027,,00000
Heartbreak Hotel,5509417,5509417,00000,,00000
Boku no kanojo wa saibôgu,5506234,00000,5506234,,00000
Piranha 3DD,5502946,370904,5132042,667364,00000
Across the Wide Missouri,5500000,5500000,00000,,00000
Three of Hearts,5495507,5495507,00000,,00000
Somos Tao Jovens,5490389,00000,5490389,,00000
Unthinkable,5483534,00000,5483534,,00000
Slums of Beverly Hills,5480318,5480318,00000,,5000000
Gridlock'd,5479037,5479037,00000,,00000
Tucker & Dale vs. Evil,5476793,223838,5252955,,5000000
Made,5476060,5308707,167353,,5000000
Ride,5476059,5476059,00000,,00000
Virgin Territory,5473041,00000,5473041,,38000000
Naqaab,5461630,00000,5461630,,00000
Martha Marcy May Marlene,5438911,2981038,2457873,,1000000
Livin' Large!,5435488,5435488,00000,,00000
Cold Comfort Farm,5433717,5433717,00000,,00000
Won't Back Down,5431486,5310554,120932,,19000000
Split Second,5430822,5430822,00000,,7000000
Arang,5428407,00000,5428407,,00000
Tango,5428387,1687311,3741076,,4500000
Human Traffic,5422740,104257,5318483,,3300000
Copie conforme,5422376,1340615,4081761,,00000
Passion Fish,5414619,5414619,00000,,00000
Meatballs II,5410972,5410972,00000,,00000
Monkeybone,5409517,5409517,00000,,75000000
The Sicilian,5406879,5406879,00000,,00000
01612,5400624,00000,5400624,,00000
She Wore a Yellow Ribbon,5400000,5400000,00000,,1600000
Diary of the Dead,5394447,952620,4441827,4748876,2750000
Racing with the Moon,5384756,5384756,00000,,00000
Rejsen til Saturn,5377665,00000,5377665,,2700000
Orlando,5367945,5367945,00000,,00000
"Show Must Go On, The",5364079,00000,5364079,,00000
A Guy Named Joe,5363000,5363000,00000,,2627000
Wolves,5361306,5361306,00000,,00000
Yuvraaj,5359114,565440,4793674,,00000
October Baby,5355847,5355847,00000,,1000000
Rocket Singh: Salesman of the Year,5348767,164649,5184118,,1070000
Equilibrium,5345869,1190018,4155851,,20000000
Drona,5342289,475104,4867185,,00000
Vollidiot,5342096,00000,5342096,,00000
L'Enfant,5341053,651941,4689112,,00000
Wu Dang,5340000,00000,5340000,,00000
Den Vyborov,5336377,00000,5336377,,00000
True Story,5328116,4719695,608421,,00000
Heavenly Creatures,5324101,2932067,2392034,,5000000
C'era una volta il West,5321508,5321508,00000,,5000000
Once Upon a Time in America,5321508,5321508,00000,,30000000
Marley,5319734,1413480,3906254,4527523,00000
Divine Madness!,5318098,5318098,00000,,00000
The Proposition,5313608,1903434,3410174,,20000000
Pane e tulipani,5311177,5311177,00000,,00000
Hot Pursuit,5310875,4215859,1095016,,00000
The Dresser,5310748,5310748,00000,,00000
Dragon Tiger Gate,5302904,00000,5302904,,00000
Metalstorm: The Destruction of Jared-Syn,5301085,5301085,00000,,00000
Ninas Mal,5300000,00000,5300000,,00000
Buddy Buddy,5299037,5299037,00000,,00000
Ironclad,5297411,00000,5297411,,25000000
Charlie Bartlett,5295909,3950294,1345615,,12000000
Suite française,5293165,00000,5293165,,00000
Dhamaal,5284202,166339,5117863,,00000
Michou D'Auber,5278633,00000,5278633,,00000
The Runaways,5278632,3573673,1704959,5139826,9500000
Once Upon a Forest,5274950,5274950,00000,,00000
Ladron que roba a ladron,5273266,4011254,1262012,,00000
San Francisco,5273000,2868000,2405000,,1300000
Devil's Pass,5272302,00000,5272302,,00000
Hear No Evil,5270563,5270563,00000,,00000
Love Letters,5269990,5269990,00000,,550000
No,5265825,2341226,2924599,608312,00000
Gardens of Stone,5262047,5262047,00000,,00000
The Lost City,5256839,2484186,2772653,,9600000
My Dinner With Andre,5250000,5250000,00000,,00000
Sivaji,5246967,00000,5246967,,00000
Indochine,5243537,5243537,00000,,00000
Black and White,5241315,5241315,00000,,10000000
The Fog of War,5233915,4198566,1035349,,00000
Siegfried & Roy: Masters of the Impossible,5231283,5231283,00000,,00000
Hollywood Shuffle,5228617,5228617,00000,,100000
The In Crowd,5217498,5217498,00000,,15000000
In God We Tru$t,5215015,5215015,00000,,00000
Balzac et la petite tailleuse chinoise,5208488,665260,4543228,,00000
Formula 51,5204007,5204007,00000,,27000000
Lovers of Six Years,5202035,00000,5202035,,00000
Once Upon a Honeymoon,5200000,5200000,00000,,00000
Tales of Manhattan,5200000,5200000,00000,,00000
Kelly's Heroes,5200000,5200000,00000,,00000
The Yearling,5200000,5200000,00000,,00000
The Comedians,5200000,5200000,00000,,00000
Clara's Heart,5194491,5194491,00000,,00000
52 Pick-Up,5186646,5186646,00000,,00000
The Object of Beauty,5186392,5186392,00000,,00000
Before Sunrise,5184616,5184616,00000,,2500000
Le gamin au vélo,5176423,1389524,3786899,,00000
Dream a Little Dream,5171429,5171429,00000,,00000
Ba wang bie ji,5158144,5158144,00000,,00000
Les Beaux Gosses,5152345,00000,5152345,,00000
Jane Eyre,5150192,5150192,00000,,00000
The House of Mirth,5149131,3041803,2107328,,10000000
Romantic Comedy,5140538,5140538,00000,,00000
Le silence de Lorna,5138795,338795,4800000,,00000
The Lobster,5128756,00000,5128756,,00000
Grind,5111630,5111630,00000,,00000
La conquête,5103083,74474,5028609,,00000
Of Mice and Men,5101632,5101632,00000,,00000
The Wildest Dream,5100135,5100135,00000,,00000
Out of Bounds,5099316,5099316,00000,,00000
Sunshine,5095981,5095981,00000,,00000
Vigilante,5091888,5091888,00000,,00000
Dangerous Ground,5079851,5079851,00000,,00000
"Aram Zam Zam, Ili Vsyo Vklyucheno",5070293,00000,5070293,,00000
The Hotel New Hampshire,5068118,5068118,00000,,7500000
Black Sheep,5063452,82987,4980465,,00000
Spooks: The Greater Good,5062305,00000,5062305,,00000
"Mes amis, mes amours",5051954,00000,5051954,,00000
Two Mules for Sister Sara,5050000,5050000,00000,,00000
Exotica,5046118,5046118,00000,,1500000
The Beaver,5046038,970816,4075222,,21000000
The Swindle,5045359,245359,4800000,,10000000
Greenberg,5044262,4234170,810092,964919,00000
Welcome to the Dollhouse,5034794,4198137,836657,,800000
Monty Python and the Holy Grail,5028948,3427696,1601252,,400000
Airheads,5021868,5021868,00000,,00000
American Dreamer,5021751,5021751,00000,,00000
Stop Making Sense,5020659,5020659,00000,,00000
Les vacances du petit Nicolas,5018768,518768,4500000,,00000
Nikita,5017971,5017971,00000,,7000000
Mother and Child,5010509,1110509,3900000,,7000000
Radio Days,5007804,00000,5007804,,00000
Bubble Boy,5002310,5002310,00000,,13000000
Flawless,5000234,1200234,3800000,,00000
Pocketful of Miracles,5000000,5000000,00000,,2900000
There's No Business Like Show Business,5000000,5000000,00000,,00000
Hero and the Terror,5000000,5000000,00000,,00000
Monkey Shines,5000000,5000000,00000,,00000
The Boys Next Door,5000000,5000000,00000,,00000
Paradise,5000000,5000000,00000,,00000
Call Me Mister,5000000,5000000,00000,,00000
"The Beast from 20,000 Fathoms",5000000,5000000,00000,,210000
Death Hunt,5000000,5000000,00000,,00000
"Elvira, Mistress of the Dark",5000000,5000000,00000,,00000
Darling Lili,5000000,5000000,00000,,22000000
Hard Times,5000000,5000000,00000,,00000
Second Sight,5000000,5000000,00000,,00000
Destination Moon,5000000,5000000,00000,,00000
Seven Brides for Seven Brothers,5000000,5000000,00000,,00000
The Exterminator,5000000,5000000,00000,,00000
The Ballad of Cable Hogue,5000000,3500000,1500000,,3716946
Krabat,5000000,00000,5000000,,00000
Kochira Katsushika-ku Kamearikoenmae Hashutsujo: The Movie,4999718,00000,4999718,,00000
Miss You Already,4995822,1162653,3833169,,00000
No Small Affair,4994094,4994094,00000,,00000
MR 73,4993520,00000,4993520,,00000
Top Dog,4992085,4992085,00000,,00000
Kwong saan mei yan,4991819,00000,4991819,,00000
Invaders from Mars,4984663,4884663,100000,,12000000
Miami Rhapsody,4982279,4982279,00000,,00000
Cyprien,4972396,00000,4972396,,00000
Take Shelter,4972016,1728953,3243063,,4750000
Fanny och Alexander,4971340,4971340,00000,,00000
"The Mafia, The Salesman",4970196,00000,4970196,,00000
Keurosing,4968755,00000,4968755,,00000
Gloria,4967493,4167493,800000,,30000000
The Handmaid's Tale,4960385,4960385,00000,,00000
Jakob the Liar,4956401,4956401,00000,,15000000
Thoda Pyaar Thoda Magic,4950879,335874,4615005,,00000
Officer of the Year,4946097,00000,4946097,,00000
Robot & Frank,4934356,3317468,1616888,,2500000
Hamlet 2,4934104,4886216,47888,,9000000
Solo,4932915,4932915,00000,,00000
Jeonguk Norae Jarang,4930704,00000,4930704,,00000
One Foundation,4927651,00000,4927651,,00000
From Justin to Kelly,4922166,4922166,00000,,12000000
Surf Ninjas,4916135,4916135,00000,,00000
Babo,4913889,00000,4913889,,00000
Heaven's Prisoners,4912939,4912939,00000,,00000
Half Nelson,4911725,2697938,2213787,1538323,700000
A Song to the Sun,4907665,00000,4907665,,00000
The Playboys,4906900,4906900,00000,,00000
Aaja Nachle,4905590,484108,4421482,,00000
Giniro No Season,4904830,00000,4904830,,00000
Enron: The Smartest Guys in the Room,4900500,4064421,836079,,00000
The Lover,4899194,4899194,00000,,00000
The Anniversary Party,4898065,4013506,884559,,00000
Insaengeun Areumdawo,4894718,00000,4894718,,00000
Go Fast,4893014,00000,4893014,,00000
Rainbow Brite and the Star Stealer,4889971,4889971,00000,,00000
The Seduction,4888270,4888270,00000,,00000
High School Musical: El Desafio,4884392,00000,4884392,,00000
Innocent Blood,4877567,4877567,00000,,00000
Avan Ivan,4876819,00000,4876819,,00000
He Knows You're Alone,4875436,4875436,00000,,00000
Hilary and Jackie,4874838,4874838,00000,,00000
Genghis Khan: To the Ends of the Earth and Sea,4874498,03892,4870606,,00000
Persuasion,4874035,4874035,00000,,00000
Youth,4873774,00000,4873774,,00000
Hideous Kinky,4870258,1262786,3607472,,00000
Take This Waltz,4868453,1239692,3628761,,00000
Suburra,4868240,00000,4868240,,00000
Torch Song Trilogy,4865997,4865997,00000,,00000
Band of the Hand,4865912,4865912,00000,,00000
Galaxina,4865000,4865000,00000,,5500000
Harry & Son,4864980,4864980,00000,,00000
Rize,4857731,3278611,1579120,,700000
"Paris, je t'aime",4857374,4857374,00000,,13000000
Girl 6,4855000,4855000,00000,,12000000
"Guten Tag, Ramon",4854356,154356,4700000,,4000000
Rustlers' Rhapsody,4847085,4847085,00000,,00000
The Corporation,4843572,3493516,1350056,,00000
Ahwak,4843164,00000,4843164,,00000
La Croisière,4842801,00000,4842801,,00000
Off Beat,4842778,4842778,00000,,00000
The Angels’ Share,4835597,312339,4523258,,00000
90 Minutes in Heaven,4816142,4816142,00000,,00000
Slackers,4814244,4814244,00000,,11000000
One Missed Call Final,4810002,00000,4810002,,00000
The Honorary Consul,4800000,4800000,00000,,00000
Tere Naal Love Ho Gaya,4797619,177743,4619876,,00000
King David,4797248,4797248,00000,,00000
Jack the Bear,4796751,4796751,00000,,00000
See You in the Morning,4795009,4795009,00000,,00000
Roman de Gare,4794615,1852764,2941851,,00000
Aap Kaa Surroor,4791144,00000,4791144,,00000
Angus,4791125,4791125,00000,,00000
Into the West,4790801,4790801,00000,,00000
Bottle Shock,4785806,4048523,737283,,5000000
Quand J'Etais Chanteur,4785410,00000,4785410,,00000
The Lonely Guy,4779375,4779375,00000,,00000
Igby Goes Down,4777465,4777465,00000,,9000000
The Hunger,4774015,4774015,00000,,00000
Bee Season,4773308,1180560,3592748,,00000
"Mune, le gardien de la lune",4766872,00000,4766872,,00000
Mansfield Park,4764741,4764741,00000,,00000
The Good Mother,4764606,4764606,00000,,00000
Force,4763946,00000,4763946,,00000
Talk to Me,4755905,4526759,229146,3066189,00000
Delirious,4755853,4755853,00000,,00000
Tempest,4753540,4753540,00000,,00000
Atlas Shrugged: Part 1,4752353,4752353,00000,5720366,00000
Oggi Sposi,4752036,00000,4752036,,00000
The Fall of the Roman Empire,4750000,4750000,00000,,19000000
Violets Are Blue...,4743287,4743287,00000,,00000
"Grandview, U.S.A.",4743119,4743119,00000,,00000
A Walk on the Moon,4741987,4741987,00000,,14000000
Ida,4741716,3827060,914656,533202,2600000
Confetti,4735229,228498,4506731,,00000
Duets,4734235,4734235,00000,,16000000
"Food, Inc.",4731944,4417674,314270,11496794,1000000
Ghost in the Machine,4731273,4731273,00000,,00000
Drugstore Cowboy,4729352,4729352,00000,,00000
Tao Jie,4728896,00000,4728896,,5400000
My Summer of Love,4727375,1000915,3726460,,1700000
New York,4727279,997437,3729842,,00000
The Other Side of Heaven,4720371,4720371,00000,,7000000
Held Up,4714090,4714090,00000,,8000000
Miss March,4713059,4543320,169739,6916633,6000000
King Naresuan 3,4712115,00000,4712115,,00000
King Kong Lives,4711220,4711220,00000,,00000
Your Friends and Neighbors,4710749,4710749,00000,,00000
"Jeff, Who Lives at Home",4708127,4269426,438701,,10000000
Eve of Destruction,4704884,4704884,00000,,00000
Lope,4704421,00000,4704421,,00000
C.H.U.D.,4700000,4700000,00000,,1250000
Miller's Crossing,4693759,4693759,00000,,00000
True Identity,4693236,4693236,00000,,00000
On the Line,4690802,4365455,325347,,10000000
Eddie and the Cruisers,4685097,4685097,00000,,00000
Prince,4684666,144826,4539840,,00000
Avenging Force,4679650,4679650,00000,,00000
My Chauffeur,4676892,4676892,00000,,00000
Pi,4674331,3216970,1457361,,68000
Rogue,4673377,10452,4662925,3044541,23000000
National Lampoon's Senior Trip,4671358,4671358,00000,,00000
Evil Under the Sun,4659287,4659287,00000,,00000
Killer Joe,4659110,1291645,3367465,,10000000
The Hitman,4654288,4654288,00000,,00000
Radio Flyer,4651977,4651977,00000,,35000000
When We Were Kings,4647606,2666118,1981488,,00000
Ek Thi Daayan,4647371,00000,4647371,,00000
Japanese Story,4647054,647054,4000000,,00000
Die Teufelskicker,4643185,00000,4643185,,00000
Ip Man,4643051,00000,4643051,,00000
Two Faces of My Girlfriend,4634831,00000,4634831,,00000
Don't Come Knocking,4633357,440793,4192564,,00000
Let's Go to Prison,4630045,4630045,00000,4415855,4000000
Hamlet,4621629,00000,4621629,,00000
No Mercy for the Rude,4620791,00000,4620791,,00000
Let it Ride,4620606,4620606,00000,,00000
Apocalypse Now Redux,4615959,4615959,00000,,00000
Crossing Over,4614344,4462332,152012,2279072,00000
Lovely and Amazing,4613482,4210379,403103,,250000
January Man,4611062,4611062,00000,,00000
Longtime Companion,4609953,4609953,00000,,00000
Les Boys,4602341,4602341,00000,,00000
Eliminators,4601256,4601256,00000,,00000
River's Edge,4600000,4600000,00000,,1900000
Anchors Aweigh,4600000,4600000,00000,,00000
Sunset,4595000,4595000,00000,,00000
Absolutely Anything,4588943,00000,4588943,,00000
Submarine,4581937,467602,4114335,,1900000
00012,4581361,125120,4456241,,00000
Safari,4580625,00000,4580625,,00000
Los Girasoles Ciegos,4579058,00000,4579058,,00000
Fire with Fire,4577139,4577139,00000,,00000
Terkel i knibe,4575595,40385,4535210,,00000
Conspirators,4574135,00000,4574135,,00000
Creator,4571788,4571788,00000,,00000
Please Give,4570178,4033574,536604,,3000000
The Company Men,4569967,4444612,125355,3178421,00000
Flying By,4568257,00000,4568257,,5000000
Joe's Apartment,4566826,4566826,00000,,00000
No One Killed Jessica,4566803,442036,4124767,,00000
Graffiti Bridge,4562778,4562778,00000,,00000
Making the Grade,4561000,4561000,00000,,00000
Intermission,4560974,889857,3671117,,00000
Mumford,4559569,4559569,00000,,28700000
Lilja 4-ever,4556982,181655,4375327,,4500000
Tortilla Soup,4554161,4447014,107147,,00000
My Father,4545849,00000,4545849,,00000
People: Jet Set 2,4545743,00000,4545743,,00000
Troll,4542346,4542346,00000,,00000
Hope and Glory,4537186,4537186,00000,,00000
Dangerous Beauty,4530929,4530929,00000,,00000
Ladies vs Ricky Bahl,4513021,00000,4513021,,00000
Buck,4510920,4023123,487797,,00000
Grizzly Man,4504451,3178403,1326048,,00000
Kickin It Old Skool,4500147,4500147,00000,2514675,00000
Road to Rio,4500000,4500000,00000,,00000
Bus Stop,4500000,4500000,00000,,00000
Suspicion,4500000,4500000,00000,,00000
Night Crossing,4500000,4500000,00000,,00000
Winchester '73,4500000,4500000,00000,,00000
An American in Paris,4500000,4500000,00000,,00000
The Great Caruso,4500000,4500000,00000,,00000
SMS - Sotto mentite spoglie,4498707,00000,4498707,,00000
Bound by Honor,4496583,4496583,00000,,35000000
Diggstown,4495615,4495615,00000,,00000
Coast to Coast,4495445,4495445,00000,,00000
Only God Forgives,4494560,775849,3718711,526497,00000
This is Spinal Tap,4491645,4491645,00000,,00000
Un'Estate Ai Caraibi,4487215,00000,4487215,,00000
Flawless,4485485,4485485,00000,,27000000
Spread,4484936,250617,4234319,,00000
Dear White People,4482508,4404154,78354,587707,00000
Dong-chang-saeng,4467956,00000,4467956,,00000
Loose Cannons,4463085,4463085,00000,,00000
Joy of Sex,4463000,4463000,00000,,00000
Lantana,4460426,4460426,00000,,00000
Passchendaele,4453327,4452423,00904,,20000000
Belli di papa',4450839,00000,4450839,,00000
Dheepan,4449491,00000,4449491,,00000
Italian for Beginners,4447186,4447186,00000,,00000
Walk on Water,4443069,2712736,1730333,,00000
Love Story 2050,4432928,00000,4432928,,00000
Black Beauty,4428830,4428830,00000,,00000
Safety Not Guaranteed,4422318,4010957,411361,,750000
The Conversation,4420000,4420000,00000,,1600000
Keeping Up with the Steins,4414753,4339241,75512,,5000000
Capturing the Friedmans,4409434,3117985,1291449,,00000
Run,4409328,4409328,00000,,00000
Inchon,4408636,4408636,00000,,46000000
Les Aristos,4408441,00000,4408441,,00000
A Star is Born,4400000,4400000,00000,,00000
Thrill of a Romance,4400000,4400000,00000,,00000
For Me and My Gal,4400000,4400000,00000,,00000
The Bravados,4400000,4400000,00000,,00000
Willie and Phil,4400000,4400000,00000,,00000
Simply Irresistible,4398989,4398989,00000,,6000000
The Company of Wolves,4389334,4389334,00000,,00000
Forced Vengeance,4388500,4388500,00000,,00000
Mental,4385959,17669,4368290,,00000
Pumpkinhead,4385516,4385516,00000,,00000
"Synecdoche, New York",4383538,3083538,1300000,,20000000
Stealing Beauty,4376355,4376355,00000,,00000
A Royal Night Out,4372772,00000,4372772,,00000
Dark Angel,4372561,4372561,00000,,7000000
Fever Pitch,4371089,113384,4257705,,00000
McHale's Navy,4368453,4368453,00000,,42000000
Seven Days In Utopia,4367448,4367448,00000,,00000
Vettai,4366276,202581,4163695,,00000
Solitary Man,4360548,4360548,00000,,12500000
Wagons East,4358940,4358940,00000,,00000
The Broadway Melody,4358000,2800000,1558000,,379000
Spartan,4357745,4357745,00000,,00000
Flash of Genius,4357639,4295905,61734,,20000000
Meet the Deedles,4351341,4351341,00000,,24000000
The Mean Season,4349446,4349446,00000,,00000
Staying Together,4348025,4348025,00000,,00000
The Tao of Steve,4342203,4342203,00000,,00000
Sleeping Dogs Lie,4342159,15745,4326414,,00000
General Rouge no Gaisen,4341479,00000,4341479,,00000
Bogus,4340826,4340826,00000,,32000000
PCU,4333569,4333569,00000,,9000000
Much Ado About Nothing,4328850,4328850,00000,1195266,00000
Manatsu no Orion,4323830,00000,4323830,,00000
Dhol,4318679,00000,4318679,,00000
Flash Point,4318042,03271,4314771,,00000
Welcome,4316974,13461,4303513,,00000
Lucky Break,4316497,54606,4261891,,6000000
Dao huo xian,4314771,00000,4314771,,00000
Melvin and Howard,4309490,4309490,00000,,00000
"Haunted Samurai, The",4306083,00000,4306083,,00000
She's Funny That Way,4304784,111993,4192791,,00000
Trenchcoat,4304286,4304286,00000,,00000
Velvet Goldmine,4303343,1043487,3259856,,9000000
Bob Roberts,4300703,4300703,00000,,00000
All the Marbles,4300000,4300000,00000,,00000
Yellowbeard,4300000,4300000,00000,,00000
Thief,4300000,4300000,00000,,00000
Per qualche dollaro in più,4300000,4300000,00000,,600000
Marooned,4300000,4300000,00000,,00000
G.I. Blues,4300000,4300000,00000,,00000
Eden Lake,4294373,07321,4287052,,2000000
Evelyn,4289509,1483975,2805534,,00000
Soul Survivors,4288246,3100650,1187596,,14000000
Tomboy,4282549,130271,4152278,,00000
Best Seller,4278150,4278150,00000,,00000
Glitter,4273372,4273372,00000,,8500000
Dutch,4271022,4271022,00000,,00000
Heidi's Song,4269402,4269402,00000,,00000
Van Wilder Deux: The Rise of Taj,4261350,4261350,00000,9004733,00000
Jia zhuang qing lu,4259100,00000,4259100,,00000
Goal! 2: Living the Dream...,4259067,225067,4034000,,00000
Lambada,4248622,4248622,00000,,00000
Mr. Nanny,4247162,4247162,00000,,00000
Brick,4243996,2075743,2168253,5037537,450000
Men with Brooms,4239767,4239767,00000,,7500000
The Gospel of John,4234355,4068087,166268,,11000000
Holy Motors,4230426,641054,3589372,,4000000
Roadie,4226370,4226370,00000,,00000
Left Behind,4221341,4221341,00000,,18500000
Four Rooms,4219131,4219131,00000,,4000000
Detroit Rock City,4217115,4217115,00000,,16000000
Saya-zamurai,4213126,00000,4213126,,00000
That's Dancing,4210938,4210938,00000,,00000
Beastie Boys,4205499,00000,4205499,,00000
Richard III,4204857,2684904,1519953,,9200000
Septimo,4200000,00000,4200000,,00000
The Damned United,4199874,449865,3750009,,6400000
ESPN's Ultimate X - The Movie,4197175,4197175,00000,,00000
Sweet and Lowdown,4196621,4196621,00000,,00000
Knock Knock,4195453,36336,4159117,,00000
The Tango Lesson,4194038,1026402,3167636,,00000
Red Scorpion,4192000,4192000,00000,,00000
Les femmes de l'ombre,4183710,00000,4183710,,00000
Nitro Circus: The Movie 3D,4182062,3377000,805062,,00000
Listen to Me,4177448,4177448,00000,,00000
The Salt of the Earth,4166640,1343349,2823291,,44936
Bride Flight,4161287,501360,3659927,,00000
Twin Peaks: Fire Walk With Me,4160851,4160851,00000,,00000
Mostly Martha (Drei Sterne),4160475,4160475,00000,,00000
Good Hair,4157223,4157223,00000,,00000
Cuban Fury,4157105,57105,4100000,35642,00000
Waiting for a Miracle,4152160,00000,4152160,,00000
Witless Protection,4151836,4151836,00000,18670454,7500000
Whipped,4142507,4142507,00000,,3000000
To Gillian on Her 37th Birthday,4137645,4137645,00000,,00000
Heart Condition,4134992,4134992,00000,,00000
Comme les autres,4130967,00000,4130967,,00000
The To Do List,4128828,3491669,637159,96557,1500000
Emergo,4126617,00256,4126361,,00000
Choke,4124277,2926565,1197712,,3400000
Cliente,4121833,00000,4121833,,00000
Venom,4117958,4117958,00000,,00000
Stay,4117883,3626883,491000,,00000
Joker,4116517,169181,3947336,,00000
L'empreinte de l'ange,4112292,00000,4112292,,00000
Partners,4109724,4109724,00000,,00000
Kama Sutra,4109095,4109095,00000,,3000000
Priest,4106277,4106277,00000,,00000
This Boy's Life,4104962,4104962,00000,,00000
Changing Times,4104160,545255,3558905,,00000
The Harvey Girls,4100000,4100000,00000,,00000
Easy to Wed,4100000,4100000,00000,,00000
Until September,4097094,4097094,00000,,00000
Aibô shirîzu Kanshiki Yonezawa Mamoru no jikenbo,4089965,00000,4089965,,00000
&iexcl;Átame!,4087000,4087000,00000,,00000
Flood,4084232,00000,4084232,,00000
That's Life!,4079895,4079895,00000,,00000
Impromptu,4076211,4076211,00000,,00000
Caprice,4075000,4075000,00000,,00000
Jab Tak Hai Jaan,4074386,3047539,1026847,,9200000
Playing God,4068285,4068285,00000,,00000
Katti Batti,4068010,364932,3703078,,00000
Lisa,4067725,4067725,00000,,00000
Dinner Game,4065116,4065116,00000,,00000
Stone,4065020,1810078,2254942,4596842,22000000
Peter's Friends,4058564,4058564,00000,,00000
The Winslow Boy,4058350,4058350,00000,,00000
King's Ransom,4049527,4008527,41000,,25000000
What We Do in the Shadows,4047518,3469224,578294,,00000
Antonia,4047426,4047426,00000,,00000
Werner - Eiskalt,4046409,00000,4046409,,00000
Mediterraneo,4044228,4044228,00000,,00000
Trois couleurs: Rouge,4043000,4043000,00000,,00000
Breaking the Waves,4040691,4040691,00000,,00000
Schultze Gets the Blues,4034232,595071,3439161,,00000
Passed Away,4030793,4030793,00000,,00000
Belle de Jour,4030203,4030203,00000,,00000
Idle Hands,4023741,4023741,00000,,15000000
There Be Dragons,4020990,1069334,2951656,,36000000
Vallanzasca - Gli angeli del male,4017500,00000,4017500,,00000
Mrs. Soffel,4012827,4012827,00000,,00000
Mountains of the Moon,4011793,4011793,00000,,00000
Short Time,4010647,4010647,00000,,00000
Kissing a Fool,4002640,4002640,00000,,00000
Brainscan,4000000,4000000,00000,,00000
Die Laughing,4000000,4000000,00000,,00000
Made in Heaven,4000000,4000000,00000,,00000
Kagemusha,4000000,4000000,00000,,00000
Taras Bulba,4000000,4000000,00000,,00000
American Ninja 2: The Confrontation,4000000,4000000,00000,,350000
Buck Privates,4000000,4000000,00000,,00000
The Beast Within,4000000,4000000,00000,,00000
Jailhouse Rock,4000000,4000000,00000,,00000
The Stepford Wives,4000000,4000000,00000,,00000
Ingagi,4000000,4000000,00000,,00000
The Million Dollar Duck,4000000,4000000,00000,,00000
Willy Wonka & the Chocolate Factory,4000000,4000000,00000,,3000000
The Boogens,4000000,4000000,00000,,00000
Amazing Grace and Chuck,4000000,4000000,00000,,00000
You Can't Take It With You,4000000,4000000,00000,,1644000
Star!,4000000,4000000,00000,,00000
Blood Feast,4000000,4000000,00000,,00000
Alexander's Ragtime Band,4000000,4000000,00000,,2000000
Tai-Pan,4000000,4000000,00000,,00000
Dillinger,4000000,4000000,00000,,00000
A Yank in the R.A.F.,4000000,4000000,00000,,00000
Vamp,4000000,4000000,00000,,00000
Leonard Part 6,4000000,4000000,00000,,00000
Meet Wally Sparks,3999612,3999612,00000,,00000
The Mighty Quinn,3992420,3992420,00000,,00000
"Welcome Home, Roxy Carmichael",3989297,3989297,00000,,00000
The Story of the Weeping Camel,3982419,1751698,2230721,,00000
Goyangyi: Jookeumeul Boneun Doo Gaeui Noon,3980234,00000,3980234,,00000
Kochaj i Tancz,3977016,00000,3977016,,00000
Step Into Liquid,3975542,3681803,293739,,00000
Spider-Man/Men in Black II Double-Bill,3971552,3971552,00000,,00000
Wedding Daze,3969756,00000,3969756,,00000
Bat*21,3966256,3966256,00000,,00000
Memories of Me,3965000,3965000,00000,,00000
The Missing,3964925,00000,3964925,,00000
8 Heads in a Duffel Bag,3959990,3559990,400000,,3000000
Ed,3956785,3956785,00000,,00000
Playing by Heart,3956212,3956212,00000,,00000
Il Papa di Giovanna,3955837,00000,3955837,,00000
The Phantom of the Opera,3953745,3953745,00000,,00000
Joysticks,3952000,3952000,00000,,00000
Qualquer Gato Vira-Lata,3950978,00000,3950978,,00000
Pride,3948678,1447022,2501656,2081794,00000
Hagane no renkinjutsushi: Mirosu no seinaru hoshi,3934008,178000,3756008,,00000
The Perfect Game,3931367,1089445,2841922,,12500000
My Science Project,3922727,3922727,00000,,00000
Gracie,3922043,2956339,965704,,9000000
The Pebble and the Penguin,3918029,3918029,00000,,00000
Mrs. Palfrey at the Claremont,3917595,1717595,2200000,,00000
Earth Girls are Easy,3916303,3916303,00000,,00000
3 amis,3915346,00000,3915346,,00000
Resurrection,3910019,3910019,00000,,00000
Warlock: The Armageddon,3902679,3902679,00000,,3000000
Gordy,3901856,3901856,00000,,00000
Restoration,3901738,3901738,00000,,18000000
The Manhattan Project,3900000,3900000,00000,,00000
Glyanets,3899426,00000,3899426,,00000
L'auberge espagnole,3895664,3895664,00000,,5900000
Tian tang kou,3887998,00000,3887998,,00000
Man Trouble,3882058,3882058,00000,,00000
You Kill Me,3858964,2426851,1432113,,4000000
Flashpoint,3854833,3854833,00000,,00000
The Heavenly Kid,3852271,3852271,00000,,00000
La donna della mia vita,3838596,00000,3838596,,00000
Brick Lane,3838486,1094998,2743488,,2500000
Trailer Park Boys: The Movie,3833507,3833507,00000,,00000
Life Stinks,3832400,3832400,00000,,00000
Mommy,3832101,3498695,333406,17282,00000
The Dolphin - Story of a Dreamer,3828898,00000,3828898,,00000
To Save a Life,3824868,3777210,47658,,500000
Thanks for Sharing,3818604,1066256,2752348,487420,00000
With a Friend Like Harry,3818452,3818452,00000,,00000
Benji: Off the Leash!,3817362,3817362,00000,,00000
Tank Girl,3817132,3817132,00000,,25000000
L'hermine,3816666,00000,3816666,,00000
The Real Cancun,3816594,3816594,00000,,4000000
Go Goa Gone,3811040,295414,3515626,,00000
The Visit,3809644,186444,3623200,,00000
Better Luck Tomorrow,3809226,3802390,06836,,250000
Hide in Plain Sight,3806930,3806930,00000,,00000
The Covered Wagon,3800000,3800000,00000,,00000
Power,3800000,3800000,00000,,00000
Girl Crazy,3800000,3800000,00000,,00000
River of No Return,3800000,3800000,00000,,00000
Catfish,3798734,3237343,561391,,00000
Guyana: Crime of the Century,3798102,3798102,00000,,00000
Lost Highway,3796699,3796699,00000,,00000
Tutta la vita davanti,3795187,00000,3795187,,00000
Governess,3794031,3794031,00000,,00000
Closed Note,3790791,00000,3790791,,00000
Sweet Hearts Dance,3790493,3790493,00000,,00000
Starbuck,3790059,3790059,00000,,00000
Celeste and Jesse Forever,3787689,3103407,684282,,840000
The Fast Runner,3786801,3786801,00000,,00000
Mentiras y Gordas,3776883,00000,3776883,,00000
Le Fils d'épicier,3776454,276454,3500000,,00000
Cheech & Chong's The Corsican Brothers,3772785,3772785,00000,,00000
The Monster Squad,3769990,3769990,00000,10061728,00000
Nitro,3768878,3768878,00000,,00000
Cleaner,3768452,00000,3768452,7886902,00000
When Time Ran Out...,3763988,3763988,00000,,00000
Fathers and Daughters,3756463,00000,3756463,,00000
Imagine: John Lennon,3753977,3753977,00000,,00000
Allan Quatermain and the Lost City,3751699,3751699,00000,,00000
Hedwig and the Angry Inch,3748479,3067312,681167,,6000000
Detachment,3742697,70740,3671957,,00000
Exterminator 2,3739406,3739406,00000,,00000
The Ex,3738622,3091922,646700,2898150,00000
Diverso Da Chi,3738076,00000,3738076,,00000
Born Into Brothels: Calcutta's Red Light Kids,3735969,3430117,305852,,00000
Buddha,3734904,00000,3734904,,00000
Up at the Villa,3734271,2927319,806952,,00000
Liberty Heights,3732398,3732398,00000,,00000
Like Crazy,3731489,3395391,336098,,250000
Coffee and Cigarettes,3729806,1971135,1758671,,00000
Boychoir,3723721,366474,3357247,,00000
Machine Gun Preacher,3721988,538690,3183298,2963502,30000000
The Big Kahuna,3713451,3150107,563344,,00000
"Cuore Altrove, Il",3712251,106573,3605678,,00000
Mistress America,3710125,2465373,1244752,,00000
Fluke,3709626,3709626,00000,,00000
Jekyll and Hyde... Together Again,3707583,3707583,00000,,5000000
The Secret Lives of Dentists,3707201,3707201,00000,,00000
Thirteen Conversations About One Thing,3705923,3287435,418488,,3000000
L'Invité,3700903,00000,3700903,,00000
A Date with Judy,3700000,3700000,00000,,00000
Holiday in Mexico,3700000,3700000,00000,,00000
The Singing Nun,3700000,3700000,00000,,00000
The Day the Earth Stood Still,3700000,3700000,00000,,1200000
The Brother from Another Planet,3700000,3700000,00000,,00000
Worth Winning,3690328,3690328,00000,,00000
Pork Chop Hill,3690000,3690000,00000,,00000
Three O'Clock High,3685862,3685862,00000,,00000
The Cut,3684688,00000,3684688,,00000
The Portrait of a Lady,3684143,3684143,00000,,00000
Faccio Un Salto All'Avana,3677715,00000,3677715,,00000
Tsubaki Sanjûrô,3675205,00000,3675205,,00000
Clerks,3673138,2852326,820812,,27000
Jimmy Hollywood,3670865,3670865,00000,,00000
Laurel Canyon,3661906,3661906,00000,,00000
The Keep,3661757,3661757,00000,,00000
Days of Heaven,3660880,3446749,214131,,3000000
Feeling Minnesota,3656439,3028433,628006,,00000
The Storm Rider,3651400,00000,3651400,,00000
Born to be Wild,3649496,3649496,00000,,00000
Rokku: Wanko No Shima,3646866,00000,3646866,,00000
VIPs,3642459,00000,3642459,,00000
A La Mala,3640958,3629842,11116,27476,00000
Lo contrario al amor,3639100,00000,3639100,,00000
Calvary,3632934,3600006,32928,09553,00000
Loverboy,3625887,3625887,00000,,00000
The Iceman,3623609,1930282,1693327,1925797,10000000
White Man's Burden,3622433,3622433,00000,,00000
Lesbian Vampire Killers,3620902,00000,3620902,,2000000
Spare Parts,3618912,3618912,00000,419939,00000
Final Cut,3618825,548039,3070786,,00000
The Killer Inside Me,3617277,217277,3400000,,13000000
Barb Wire,3615658,3615658,00000,,00000
Epitaph,3608964,00000,3608964,,00000
Crime d'amour ,3607225,538356,3068869,,00000
BloodRayne,3605420,2405420,1200000,10877394,25000000
24 Hour Party People,3604965,1169030,2435935,,00000
My Heroes Have Always Been Cowboys,3603615,3603615,00000,,00000
Ziegfeld Follies,3600000,3600000,00000,,00000
This Time for Keeps,3600000,3600000,00000,,00000
Two Sisters from Boston,3600000,3600000,00000,,00000
Genghis Blues,3599174,3599174,00000,,00000
Bordertown,3598262,00000,3598262,,00000
Finding Vivian Maier,3597384,1509131,2088253,507906,00000
La traviata,3594000,3594000,00000,,00000
A Gun in Betty Lou's Handbag,3591460,3591460,00000,,00000
Wish I Was Here,3591299,3591299,00000,135951,6000000
Dead Heat,3588626,3588626,00000,,00000
Stand Up Guys,3587933,3310031,277902,2866561,00000
Out of Rosenheim,3587303,3587303,00000,,00000
Gerhard Richter Painting,3586195,2374911,1211284,,00000
Ikigami,3585144,00000,3585144,,00000
The Secret of Kells,3582797,690290,2892507,,8000000
Holy Smoke,3580723,1758780,1821943,,00000
Cruising Bar 2,3579013,3579013,00000,,00000
The Sidewalks of New York,3575308,2402459,1172849,,1000000
The Jane Austen Book Club,3575227,3575227,00000,,00000
Old Gringo,3574256,3574256,00000,,00000
The New Adventures of Pippi Longstocking,3569939,3569939,00000,,00000
Io che amo solo te,3569880,00000,3569880,,00000
Turk 182!,3563635,3563635,00000,,00000
Cats Don't Dance,3562749,3562749,00000,,32000000
Fat Man and Little Boy,3560942,3560942,00000,,00000
Tom and Jerry: The Movie,3560469,3560469,00000,,00000
Gekijoban Kamen Raida Den'o and Kiba Kuraimakkusu Deka,3558763,00000,3558763,,00000
The Bride,3558669,3558669,00000,,00000
Phoenix,3556841,3166858,389983,,00000
Nintama Rantar_,3555453,00000,3555453,,00000
Tanu Weds Manu Returns,3554629,3043479,511150,,00000
Honkytonk Man,3553830,3553830,00000,,00000
Junebug,3553253,2678010,875243,,1000000
Major League: Back to the Minors,3551208,3551208,00000,,00000
Madame Sousatzka,3548000,3548000,00000,,00000
Un altro mondo,3544674,00000,3544674,,00000
The Joneses,3541565,1475746,2065819,,10000000
Pieces of April,3540733,2498144,1042589,,300000
"Testosteron (Poland, 2007)",3540470,00000,3540470,,00000
New Jersey Drive,3540207,3540207,00000,,00000
The Trigger Effect,3539660,3539660,00000,,00000
The Challenge,3534852,3534852,00000,,00000
Prey,3533999,00000,3533999,,00000
Dil Dhadakne Do,3533783,3066100,467683,,00000
In Country,3531971,3531971,00000,,00000
Things Change,3527886,3527886,00000,,00000
Free Willy 3: The Rescue,3519178,3519178,00000,,00000
The Tall Guy,3510000,510000,3000000,,00000
The Pest,3506206,3506206,00000,,00000
Fireflies in the Garden,3505823,36884,3468939,,00000
Bad Company,3504008,3504008,00000,,00000
Words and Music,3500000,3500000,00000,,00000
Deep in my Heart,3500000,3500000,00000,,00000
Fiesta,3500000,3500000,00000,,00000
Thousands Cheer,3500000,3500000,00000,,00000
The Wraith,3500000,3500000,00000,,00000
State Fair,3500000,3500000,00000,,4500000
Two Girls and a Sailor,3500000,3500000,00000,,00000
Bathing Beauty,3500000,3500000,00000,,2361000
Per un pugno di dollari,3500000,3500000,00000,,200000
The Glacier Fox,3500000,3500000,00000,,00000
Casanova's Big Night,3500000,3500000,00000,,00000
What If,3493000,3493000,00000,364027,00000
El Greco,3489694,00000,3489694,,00000
Dark Places,3486017,208588,3277429,555781,00000
Veronica Mars,3485383,3322127,163256,3313398,6000000
Heaven's Gate,3484331,3484331,00000,,44000000
Bully,3483795,3483795,00000,,00000
Camping Sauvage,3479302,3479302,00000,,4600000
Til There Was You,3478370,3478370,00000,,00000
Matrimonio al Sud,3472448,00000,3472448,,00000
Kara Bela,3471304,00000,3471304,,00000
Cabin Boy,3469493,3469493,00000,,00000
Talk Radio,3468572,3468572,00000,,4000000
Shout,3463620,3463620,00000,,00000
Bheja Fry 2,3463589,22266,3441323,,00000
"Next Stop, Wonderland",3456820,3386698,70122,,1000000
Shattered Glass,3456602,2207975,1248627,,6000000
Renoir,3456140,2291047,1165093,,00000
Jean de Florette,3452836,3452836,00000,,00000
B Jia Zhen Tan,3451602,00000,3451602,,00000
Neptune's Daughter,3450000,3450000,00000,,00000
Rock On,3443103,00000,3443103,,00000
Beneath Hill 60,3440939,00000,3440939,53110,9000000
The Trip,3440604,2016345,1424259,,00000
Full Frontal,3438804,2512846,925958,,2000000
The Ultimate Gift,3438735,3438735,00000,,9000000
Irina Palm,3437024,44064,3392960,,00000
Bathory,3436763,00000,3436763,,15000000
Price of Glory,3434515,3434515,00000,,00000
Child 44,3434330,1224330,2210000,,50000000
He Named Me Malala,3432258,2626019,806239,,00000
Malena,3429045,3429045,00000,,00000
Bu Zai Rang Ni Gu Dan,3428950,00000,3428950,,00000
Gunmen,3426347,3426347,00000,,00000
A Shock to the System,3417056,3417056,00000,,00000
The Grand Seduction,3409304,3409304,00000,,00000
Room,3406551,3406551,00000,,00000
A Simple Twist of Fate,3404935,3404935,00000,,00000
Born American,3401376,3401376,00000,,00000
In the Good Old Summertime,3400000,3400000,00000,,00000
Maytime,3400000,3400000,00000,,00000
The Lemon Sisters,3399773,3399773,00000,,00000
Lezioni di Cioccolato,3397829,00000,3397829,,00000
The Company,3396508,2281585,1114923,,15000000
Head Office,3393807,3393807,00000,,00000
Ladrones,3392724,3063505,329219,,00000
Angels and Insects,3390811,3390811,00000,,00000
Cosmopolis,3388399,743636,2644763,,00000
Wrong is Right,3379569,3379569,00000,,00000
Camille Redouble,3379146,38243,3340903,,00000
CitizenFour,3378586,2800870,577716,,00000
Is Anybody There?,3377778,2026756,1351022,,00000
The MatchMaker,3376403,3376403,00000,,00000
Sagan,3375087,00000,3375087,,00000
Curse of the Pink Panther,3374312,3374312,00000,,00000
Monsieur Lazhar,3371810,3371810,00000,,00000
Near Dark,3369307,3369307,00000,,00000
My Architect,3368107,2748981,619126,,00000
Nautanki Saala!,3367990,00000,3367990,,00000
Moll Flanders,3363968,3363968,00000,,00000
Starchaser: The Legend of Orin,3360800,3360800,00000,,00000
The School of Flesh,3359031,3359031,00000,,00000
Paradise Now,3357075,1452402,1904673,,00000
Head in the Clouds,3356253,398179,2958074,,00000
Unknown,3355048,26403,3328645,,3700000
My One and Only,3348954,2556558,792396,1578926,00000
The Work and the Glory,3347439,3347439,00000,,7500000
Together,3347322,1032223,2315099,,00000
Words and Pictures,3345795,2171257,1174538,784077,00000
Oldboy,3343567,2193658,1149909,472689,00000
Atlas Shrugged: Part II,3336053,3336053,00000,,10000000
The Last Kiss,3335177,1048950,2286227,11051062,00000
Fraternity Vacation,3333306,3333306,00000,,00000
Camille Claudel,3331297,3331297,00000,,00000
The Wackness,3330012,2077046,1252966,,6000000
Fifty,3328240,3328240,00000,,00000
U Me Aur Hum,3328191,1028191,2300000,,00000
La Tourneuse de Pages,3325937,208691,3117246,,00000
Maskeli Besler,3325862,00000,3325862,,00000
Les deux mondes,3325436,00000,3325436,,00000
Obvious Child,3324070,3122616,201454,141506,1000000
Eiga Yes! PreCure 5: Kagami no Kuni no Miracle Daiboken!,3319368,00000,3319368,,00000
Squanto: A Warrior's Tale,3319344,3319344,00000,,00000
A Smile Like Yours,3317930,3317930,00000,,00000
00013,3317662,00000,3317662,,00000
Elvis Gratton 2,3316272,3316272,00000,,00000
Last Ounce of Courage,3310439,3310439,00000,,00000
Carpool,3308758,3308758,00000,,00000
Omar M'a Teur,3303155,00000,3303155,,00000
"Election Day, The",3300702,00000,3300702,,00000
Mannequin: On the Move,3300609,3300609,00000,,00000
Raaz 2: The Mystery Continues,3300000,00000,3300000,,00000
Happily Ever After,3299382,3299382,00000,,00000
Art School Confidential,3297137,3297137,00000,,00000
Pootie Tang,3293258,3293258,00000,,3500000
Riding Giants,3292333,2276368,1015965,,2600000
Bluff Master,3285156,718956,2566200,,00000
The Reef 2: High Tide,3283366,00000,3283366,,00000
Dry White Season,3282890,3282890,00000,,00000
Let's Spend the Night Together,3282561,3282561,00000,,00000
Provoked: A True Story,3282269,918931,2363338,,00000
Looker,3281232,3281232,00000,,00000
Ten Canoes,3277991,277991,3000000,,00000
Romeo Is Bleeding,3275585,3275585,00000,,10000000
Only the Strong,3273588,3273588,00000,,6000000
Pathology,3270974,109045,3161929,,8000000
Tadpole,3270128,2891288,378840,,150000
Mi Vida Loca,3269420,3269420,00000,,00000
Original Gangstas,3268414,3268414,00000,,00000
Father Hood,3268203,3268203,00000,,00000
Taxi,3265051,281549,2983502,,00000
Mrs. Dalloway,3263672,3263672,00000,,00000
The Glass Shield,3262024,3262024,00000,,00000
Death Before Dishonor,3261973,3261973,00000,,00000
Pinocchio and the Emperor of the Night,3261638,3261638,00000,,00000
Resurrecting the Champ,3260555,3172382,88173,3821394,13000000
Loufa Kai Apallagi - I4,3258957,00000,3258957,,00000
China Cry: A True Story,3254801,3254801,00000,,00000
The Son,3254009,70034,3183975,,00000
Supercross,3252550,3102550,150000,,30000000
Gymkata,3249442,3249442,00000,,00000
Splitting Heirs,3246063,3246063,00000,,00000
Mr. X,3244995,44995,3200000,,00000
The Edge of Love,3238922,33260,3205662,,00000
Blue Sky,3235241,3235241,00000,,00000
The Imposter,3232717,901954,2330763,,00000
Romance and Cigarettes,3231251,551002,2680249,,11000000
Dachimawa Lee,3229037,00000,3229037,,00000
"Don Gato, el inicio de la pandilla",3227259,00000,3227259,,80000000
Jeffrey,3222819,3222819,00000,,00000
Little Fish,3222453,22453,3200000,,00000
Barfly,3221000,3221000,00000,,00000
My Boyfriend's Back,3218882,3218882,00000,,00000
The Wild Parrots of Telegraph Hill,3218709,3058527,160182,,00000
Everlasting Moments,3210825,610825,2600000,,00000
The Boys are Back,3209752,809752,2400000,,00000
Nous trois ou rien,3205502,00000,3205502,,00000
Top Hat,3202000,1782000,1420000,,609000
La Delicatesse,3200055,00000,3200055,,00000
On an Island with You,3200000,3200000,00000,,00000
Vertigo,3200000,3200000,00000,,00000
Road to Singapore,3200000,3200000,00000,,00000
Murder 3,3200000,00000,3200000,,00000
Radio Star,3199863,00000,3199863,,00000
Stonehearst Asylum,3197693,00000,3197693,,00000
Silent Fall,3180000,3180000,00000,,00000
Le sens de l'humour,3179193,3179193,00000,,00000
Ladda Land,3178768,00000,3178768,,00000
The Cat's Meow,3176936,3176936,00000,,00000
Ride,3176650,3176650,00000,,00000
Wordplay,3175921,3119555,56366,,500000
Rude Awakening,3169719,3169719,00000,,00000
Rosewater,3168858,3128941,39917,354602,10000000
Crash,3168660,3168660,00000,,10000000
Clifford's Really Big Movie,3164202,2831130,333072,,00000
Fuera De Carta,3162337,00000,3162337,,00000
My Mom's New Boyfriend,3161218,00000,3161218,,00000
The Bad Education Movie,3159919,00000,3159919,,00000
Nos 18 ans,3156149,00000,3156149,,00000
From Prada to Nada,3153623,3033623,120000,,00000
Green Street Hooligans,3153337,345821,2807516,,00000
Dear Frankie,3147385,1340891,1806494,,4600000
In a World...,3139211,2963271,175940,319927,00000
Rock the Kasbah,3136247,3020665,115582,,00000
Beautiful,3134509,3134509,00000,,9000000
Maurice,3130592,3130592,00000,,2600000
Imagine Me & You,3129471,672243,2457228,,7900000
Boynton Beach Club,3127472,3127472,00000,,2900000
Mr. Wonderful,3125000,3125000,00000,,00000
Coogan's Bluff,3110000,3110000,00000,,00000
White Mischief,3107000,3107000,00000,,00000
Girl Happy,3100000,3100000,00000,,00000
The Last House on the Left,3100000,3100000,00000,,87000
The Legend of Billie Jean,3099497,3099497,00000,,00000
The Favor,3098590,3098590,00000,,00000
Traces of Red,3098235,3098235,00000,,00000
American Adobo,3094699,3094699,00000,,00000
Russkiy kovcheg,3092976,3092976,00000,,00000
Your Sister's Sister,3090593,1597486,1493107,,120000
Kinjite,3088086,3088086,00000,,00000
"Steal Big, Steal Little",3087268,3087268,00000,,00000
La Moustache,3078324,244771,2833553,,00000
Speed Zone!,3077061,3077061,00000,,00000
Jawbreaker,3076820,3076820,00000,,3000000
Dominick and Eugene,3076031,3076031,00000,,00000
Paid in Full,3075052,3042188,32864,,00000
Messenger of Death,3074681,3074681,00000,,00000
Wu Jia Zhi Bao,3071161,00000,3071161,,00000
The Resident,3069729,00000,3069729,,00000
The Public Eye,3067917,3067917,00000,,00000
Sunshine State,3064356,3064356,00000,,5600000
Tristram Shandy: A Cock and Bull Story,3061763,1253413,1808350,,4750000
The Widow of St. Pierre,3058380,3058380,00000,,13000000
Illegal Tender,3054430,3054430,00000,,00000
Songcatcher,3050934,3050934,00000,,1800000
Stories We Tell,3043717,1602160,1441557,,00000
K2,3042892,3042892,00000,,00000
Ragini MMS,3042374,00000,3042374,,00000
The Fate,3040410,00000,3040410,,00000
The Mother,3038677,1062253,1976424,,00000
China Moon,3038499,3038499,00000,,00000
The Golden Bowl,3037579,3037579,00000,,00000
"Je Vais Bien, Ne T'en Fais Pas",3036690,00000,3036690,,00000
Survivre avec les Loups,3033368,00000,3033368,,00000
The Pact,3026565,00000,3026565,,00000
Amour & turbulences,3022302,08425,3013877,,00000
G,3020784,3020784,00000,,00000
Still of the Night,3017965,3017965,00000,,00000
Fighting Back,3016496,3016496,00000,,00000
Anacleto: Agente secreto,3015786,00000,3015786,,00000
Trailer Park Boys: Countdown to Liquor Day,3012677,3012677,00000,,00000
Carrington,3010656,3010656,00000,,00000
Thaandavam,3006802,213476,2793326,,00000
Ju-On: The Grudge,3005548,325661,2679887,,00000
Que Horas Ela Volta?,3003079,372508,2630571,,1200000
Monsieur Papa,3001987,00000,3001987,,00000
Sorte Kugler,3001084,00000,3001084,,00000
Waikiki Wedding,3000000,3000000,00000,,00000
Roustabout,3000000,3000000,00000,,00000
Lost Horizon,3000000,3000000,00000,,00000
Le dernier métro,3000000,3000000,00000,,00000
Myra Breckinridge,3000000,3000000,00000,,00000
Le grand bleu,3000000,3000000,00000,,00000
American Anthem,3000000,3000000,00000,,00000
Macumba Love,3000000,3000000,00000,,00000
Sweethearts,3000000,3000000,00000,,00000
Mirage,3000000,3000000,00000,,00000
The Jazz Singer,3000000,3000000,00000,,00000
Feds,3000000,3000000,00000,,00000
The World in His Arms,3000000,3000000,00000,,00000
The Great Ziegfeld,3000000,3000000,00000,,00000
The Philadelphia Story,3000000,3000000,00000,,00000
Hanover Street,3000000,3000000,00000,,00000
Speedway,3000000,3000000,00000,,00000
Forbidden Planet,3000000,3000000,00000,,00000
Westworld,3000000,3000000,00000,,00000
Critters 2: The Main Course,3000000,3000000,00000,,00000
The Bandit of Sherwood Forest,3000000,3000000,00000,,00000
Alamo of the South Seas,3000000,3000000,00000,,00000
My Demon Lover,3000000,3000000,00000,,00000
Big Shots,3000000,3000000,00000,,00000
Honky Tonk,3000000,3000000,00000,,00000
That's Entertainment part 2,3000000,3000000,00000,,00000
Malone,3000000,3000000,00000,,10000000
Over the Hill to the Poorhouse,3000000,3000000,00000,,100000
Without Reservations,3000000,3000000,00000,,00000
Fengkuang de Shitou,3000000,00000,3000000,,500000
Crumb,2999033,2979456,19577,,00000
Pawn Sacrifice,2997674,2428415,569259,,00000
Mission Istaanbul,2997278,29269,2968009,,00000
Bullies,2995527,2995527,00000,,00000
North Sea Hijack,2993772,2993772,00000,,00000
The End of the Tour,2993606,2977713,15893,,00000
Shoot on Sight,2992880,1350230,1642650,,00000
Mark Twain's America 3D,2992106,2992106,00000,,00000
On ne choisit pas sa famille,2987953,00000,2987953,,00000
The Last Days of Disco,2987297,2987297,00000,,00000
Princess Caraboo,2984777,2984777,00000,,00000
The Homesman,2974779,2429989,544790,1990440,16000000
The Blinky Bill Movie,2962965,00000,2962965,,00000
The Pirate,2956000,2956000,00000,,3700000
976-Evil,2955917,2955917,00000,,00000
Victoria,2954407,06971,2947436,,00000
Isn't She Great,2954405,2954405,00000,,36000000
My Tutor Friend 2,2952412,00000,2952412,,00000
Direkt&oslash;ren for det hele,2951300,51300,2900000,,00000
O Piseu,2945170,34144,2911026,,00000
The Met: Live in HD - Aida,2943797,2800000,143797,,00000
Hidalgo: La historia jamás contada,2941672,00000,2941672,,00000
Southern Comfort,2939174,2939174,00000,,00000
Strayed,2938432,482357,2456075,,00000
Metropolitan,2938000,2938000,00000,,430000
Meu Nome Nao E Johnny,2937005,00000,2937005,,00000
Joan Rivers: A Piece of Work,2930687,2930687,00000,,00000
Man Up,2928710,00000,2928710,,00000
Kein Bund fürs Leben,2927117,00000,2927117,,00000
Waiting for Guffman,2922988,2922988,00000,,4000000
This is My Life,2922094,2922094,00000,,00000
Doctor Who: The Day of the Doctor,2918455,00000,2918455,,00000
Genis Aile: Yapistir,2916840,00000,2916840,,00000
Homework,2914328,2914328,00000,,00000
Crimes of Passion,2912945,2912945,00000,,00000
Hwaiteu: Jeojooui Mellodi,2912396,00000,2912396,,00000
Dschungelkind,2911348,00000,2911348,,00000
Demonic,2909714,00000,2909714,,3000000
Letters to God,2908902,2848587,60315,6129425,3000000
"Ja, Ik Wil!",2908354,00000,2908354,,00000
Death and the Maiden,2905642,2905642,00000,,00000
Geulimja Salin,2904792,00000,2904792,,00000
Sylvia,2904137,1302242,1601895,,00000
Karthik Calling Karthik,2901846,286409,2615437,,00000
Raising Victor Vargas,2900578,2073984,826594,,800000
Midnight Madness,2900000,2900000,00000,,00000
On the Town,2900000,2900000,00000,,00000
Cradle Will Rock,2899970,2899970,00000,,32000000
Find Me Guilty,2898225,1173673,1724552,,13000000
Alexander. Nevsky Battle,2894758,00000,2894758,,00000
Peaceful Warrior,2893666,2893666,00000,,00000
Waking Life,2892011,2892011,00000,,00000
Blame it on the Bellboy,2891055,2891055,00000,,00000
The Warrior and the Sorceress,2886225,2886225,00000,,00000
La grande bellezza,2883879,2883879,00000,,00000
No Man's Land,2877571,2877571,00000,,00000
God Tussi Great Ho,2874504,121432,2753072,,00000
Love! Valour! Compassion!,2874242,2874242,00000,,00000
The Trip to Italy,2873758,2873758,00000,539286,00000
Badlapur,2865534,2825542,39992,,00000
Rappin',2864844,2864844,00000,,00000
Andre Rieu's 2015 Maastricht Concert,2862599,00000,2862599,,00000
Jindabyne,2862544,399879,2462665,,10800000
Home Run,2859955,2859955,00000,1804506,1200000
Airborne,2859811,2859811,00000,,00000
In the Company of Men,2856622,2856622,00000,,25000
The Man in the Moon,2853801,2853801,00000,,00000
Filly Brown,2850357,2850357,00000,,1250000
Night of the Demons,2847907,2847907,00000,,00000
Elsa & Fred,2847024,189024,2658000,,00000
Rivers and Tides,2846816,2200276,646540,,00000
Othello,2844379,2844379,00000,,11000000
Truth,2843544,2436413,407131,,00000
eXistenZ,2840417,2840417,00000,,20700000
Marius et Jeannette,2835851,2835851,00000,,00000
Running on Empty,2835116,2835116,00000,,00000
Shallow Grave,2834250,2834250,00000,,00000
Unzipped,2833010,2833010,00000,,00000
Reservoir Dogs,2832029,2832029,00000,20013615,1200000
Ouran Koukou Hosutobu,2831865,00000,2831865,,00000
Adam,2828590,2277396,551194,,3200000
The Identical,2827666,2827666,00000,136904,00000
The Fluffy Movie,2827393,2827393,00000,2811600,00000
Chakravyuh,2827265,00000,2827265,,00000
The Power of One,2827107,2827107,00000,,00000
"Bianca come il latte, rossa come il sangue",2823631,00000,2823631,,00000
Everything Must Go,2821010,2712131,108879,1519302,5000000
De Taali,2818022,00000,2818022,,00000
Restless,2817782,163141,2654641,,8000000
Un Giorno Perfetto,2815026,00000,2815026,,00000
XP3D,2812739,00000,2812739,,00000
The White Countess,2810857,1666262,1144595,,16000000
Yor: Hunter From the Future,2810199,2810199,00000,,00000
Map of the Human Heart,2806881,2806881,00000,,00000
Loving Couples,2806659,2806659,00000,,00000
Deadly Blessing,2800000,2800000,00000,,00000
The Clock,2800000,2800000,00000,,00000
Three Little Words,2800000,2800000,00000,,00000
Kissin' Cousins,2800000,2800000,00000,,00000
All is Well,2798419,00000,2798419,,00000
Quinceanera,2797199,1692693,1104506,,400000
"Happy, Texas",2795685,1943649,852036,,1700000
Love Stinks,2793776,2793776,00000,,4000000
Year of the Comet,2791515,2791515,00000,,00000
Jiro Dreams of Sushi,2790035,2552478,237557,,00000
Love and Other Disasters,2789144,00000,2789144,,00000
Hexed,2786807,2786807,00000,,00000
The Sword with no Name,2786388,00000,2786388,,00000
"Ma Fille, Mon Ange",2779545,2779545,00000,,00000
Saving Christmas,2778297,2778297,00000,,00000
Gabrielle,2775311,332829,2442482,,00000
Kill the Messenger,2767998,2450846,317152,1692849,5000000
Vers le sud,2767187,898294,1868893,,00000
Impulse,2766716,2766716,00000,,00000
Clouds of Sils Maria,2759715,1841555,918160,198552,00000
Rann,2758179,165873,2592306,,00000
Captive,2757776,2583301,174475,,2000000
40858,2756875,38100,2718775,,00000
Mi gran noche,2755666,00000,2755666,,00000
Freeriders,2750064,2750064,00000,,00000
Million Dollar Mermaid,2750000,2750000,00000,,00000
Les Girls,2750000,2750000,00000,,00000
Comedian,2744253,2744253,00000,,00000
Der kleine Rabe Socke - Das große Rennen,2743406,00000,2743406,,00000
The Immigrant,2739027,2013456,725571,,00000
Atithi Tum Kab Jaoge?,2738610,235847,2502763,,00000
C'e chi dice no,2738533,00000,2738533,,00000
Shadows and Fog,2735731,2735731,00000,,00000
Shall We Kiss?,2735499,535499,2200000,,00000
Sightseers,2735440,41039,2694401,119203,00000
Hot Moves,2732684,2732684,00000,,00000
Blood Simple,2730877,1690913,1039964,,1500000
Basquiat,2729067,2729067,00000,,3000000
Ils,2726062,26062,2700000,,00000
Control Room,2724826,2589616,135210,,00000
The Good Lie,2722209,2722209,00000,,00000
Dr. Jekyll and Ms. Hyde,2721955,2721955,00000,,00000
Ajami,2721096,621859,2099237,,1000000
G.P. 506,2720834,00000,2720834,,00000
Dans une galaxie près de chez vous - Le film,2717807,2164047,553760,,00000
Criss Cross,2717764,2717764,00000,,00000
Goodbye Bafana,2717302,00000,2717302,,30000000
Homicide,2716765,2716765,00000,,00000
La doppia ora,2715751,1514942,1200809,,00000
Cheri,2715657,2715657,00000,,23000000
Straight out of Brooklyn,2712293,2712293,00000,,450000
Saat Khoon Maaf ,2709854,273083,2436771,,00000
Factotum,2708087,808221,1899866,,00000
The One and Only,2707679,2707679,00000,,00000
Sukai Kurora,2707659,00000,2707659,,00000
Newsies,2706352,2706352,00000,,00000
Pájaros de Papel,2705914,00000,2705914,,00000
Auto Focus,2703821,2062066,641755,,7000000
Bronson,2703762,104979,2598783,,230000
The Allnighter,2700000,2700000,00000,,00000
Another You,2697777,2697777,00000,,00000
Im Labyrinth des Schweigens,2697359,710253,1987106,,00000
Bobby Jones: Stroke of Genius,2694071,2694071,00000,,17000000
A Perfect Day,2690243,00000,2690243,,00000
The Bear,2687148,2687148,00000,,00000
Bright Young Things,2682600,933637,1748963,,00000
Testament of Youth,2678443,1822250,856193,91998,00000
"After Dark, My Sweet",2678414,2678414,00000,,00000
Diva,2678103,2678103,00000,,00000
No Man's Land,2676556,1059830,1616726,,1000000
Fool and Final,2673450,00000,2673450,,00000
La meglio gioventù,2673253,254224,2419029,,00000
Camp,2670379,1628154,1042225,,00000
The Perez Family,2669359,2669359,00000,,11000000
The Scout,2667163,2667163,00000,,00000
Redbelt,2667084,2344847,322237,,7000000
Commando,2667034,00000,2667034,,00000
Barbie in Rock'n Royals,2658072,00000,2658072,1927864,00000
Trumbo,2655086,2655086,00000,,00000
The Show,2652810,2652810,00000,,00000
Fast Forward,2650866,2650866,00000,,00000
Haunt,2648068,00000,2648068,164865,00000
Napoléon,2645504,2645504,00000,,00000
God's Army,2643618,2628829,14789,,300000
One Night Stand,2642718,2642718,00000,,00000
Every Little Step,2640141,1725141,915000,,00000
Cannery Row,2638311,2638311,00000,,00000
Vivir es fácil con los ojos cerrados,2632465,00000,2632465,,00000
Sex and Lucia,2628241,2628241,00000,,00000
Mississippi Mermaid,2627795,27795,2600000,,1600000
Therese,2627016,2627016,00000,,00000
Babine,2626308,2626308,00000,,00000
Serbuan maut 2: Berandal,2625803,2625803,00000,1016881,00000
The Idolmaker,2625716,2625716,00000,,00000
Desperate Hours,2624629,2624629,00000,,00000
Kids in the Hall: Brain Candy,2621887,2621887,00000,,00000
Shalako,2620000,2620000,00000,,1455000
Infamous,2613717,1151330,1462387,,13000000
Girl in Progress,2609412,2609412,00000,,00000
Indigo,2607447,00000,2607447,,00000
O Ano em Que Meus Pais Saíram de Férias,2607117,807117,1800000,,00000
Middonaito Îguru,2607116,07116,2600000,,00000
Cidade dos Homens,2606553,307076,2299477,,00000
Da hong deng long gao gao gua,2603061,2603061,00000,,00000
Girls! Girls! Girls!,2600000,2600000,00000,,00000
Fancy Pants,2600000,2600000,00000,,00000
Duchess of Idaho,2600000,2600000,00000,,00000
Omkara,2599402,1244576,1354826,,00000
The Riot Club,2596114,06041,2590073,20703,00000
N-Secure,2595644,2595644,00000,,1600000
Simon och ekarna,2594930,150109,2444821,,00000
The Gatekeepers,2592308,2408553,183755,,1500000
House of Games,2585639,2585639,00000,,00000
The Fall,2573751,2273751,300000,3507849,00000
Girl Most Likely,2571741,1378591,1193150,93404,00000
Behind the Candelabra,2568300,00000,2568300,1080855,00000
18 Again!,2567099,2567099,00000,,00000
Maxie,2564278,2564278,00000,,00000
Popcorn,2563365,2563365,00000,,00000
Brassed Off,2560471,2560471,00000,,00000
Bad Medicine,2549195,2549195,00000,,00000
Trust the Man,2548378,1530535,1017843,,9000000
Caregiver,2547894,00000,2547894,,00000
Streets of Gold,2546238,2546238,00000,,00000
True Stories,2545142,2545142,00000,,00000
Love and Death on Long Island,2542264,2542264,00000,,4030000
L'homme du train,2541320,2541320,00000,,00000
Naked Lunch,2541000,2541000,00000,,00000
Zero Kelvin,2540000,05000,2535000,,00000
The King of Comedy,2536242,2536242,00000,,00000
The Sweeney,2532091,26345,2505746,,4500000
Impulse,2531528,2531528,00000,,00000
Bucky Larson: Born to Be a Star,2529395,2529395,00000,,10000000
When The Cat's Away,2525984,1652472,873512,,300000
Novocaine,2522928,2025238,497690,,6000000
Le retour de Martin Guerre,2522881,2522881,00000,,00000
Eiga Precure All-Stars DX Minna Tomodachi,2519909,00000,2519909,,00000
Magic in the Water,2518372,2518372,00000,,00000
Iron Eagle 3: Aces,2517600,2517600,00000,,00000
The Evil Twin,2517430,00000,2517430,,00000
A Private Function,2516761,2516761,00000,,00000
Loong Boonmee raleuk chat ,2514148,184292,2329856,,00000
But I'm a Cheerleader,2509344,2205627,303717,,1200000
Grace Unplugged,2507159,2507159,00000,3575284,1700000
Career Girls,2506039,2506039,00000,,00000
The Queen of Versailles,2505100,2401999,103101,,00000
"Águila Roja, La Película",2504858,00000,2504858,,00000
Ridicule,2503829,2503829,00000,,00000
Calendar Girl,2501113,2501113,00000,,00000
Niagara,2500000,2500000,00000,,1250000
The Kid,2500000,2500000,00000,,00000
On the Riviera,2500000,2500000,00000,,00000
The Black Marble,2500000,2500000,00000,,00000
"Paradise, Hawaiian Style",2500000,2500000,00000,,00000
It Happened One Night,2500000,2500000,00000,,325000
Hangul,2499546,22080,2477466,,00000
Gli ultimi saranno ultimi,2496578,00000,2496578,,00000
Blancanieves,2495971,236394,2259577,,00000
Rumble Fish,2494480,2494480,00000,,00000
Antichrist,2492704,404122,2088582,,00000
Desert Hearts,2492088,2492088,00000,,00000
"Silent Night, Deadly Night",2491460,2491460,00000,,00000
Choose Me,2490233,2490233,00000,,00000
The Stepfather,2488740,2488740,00000,,00000
Pur Week-end,2488495,00000,2488495,,00000
Black,2486194,00000,2486194,,00000
The Cure,2485520,2485520,00000,,00000
Unforgettable,2483790,2483790,00000,,18000000
After.Life,2481925,108596,2373329,,4500000
Himalaya - l'enfance d'un chef,2481690,2481690,00000,,00000
El Gran Milargro,2479418,00000,2479418,,00000
The Incredibly True Adventure of Two Girls in Love,2477155,2210408,266747,,250000
And When Did You Last See Your Father?,2476491,1071240,1405251,,8000000
Kick,2472695,2472695,00000,,00000
Omerta,2462588,2462588,00000,,00000
Pastorela,2461744,161194,2300550,,00000
Son of the Pink Panther,2457574,2457574,00000,,00000
Turist,2456677,1359497,1097180,48267,00000
Gleaming the Cube,2454590,2454590,00000,,00000
The Endurance: Shackleton's Legendary Antarctic Expedition,2452566,2452566,00000,,00000
Cote d'Azur,2446611,140439,2306172,,00000
The Men's Club,2444076,2444076,00000,,00000
Gojira,2443200,2443200,00000,,00000
Jefferson in Paris,2442542,2442542,00000,,14000000
Afterglow,2441642,2441642,00000,,00000
Lost in La Mancha,2440345,734514,1705831,,00000
Le Secret de ma Mere,2438595,2438595,00000,,00000
Four Lions,2436111,310007,2126104,,3750000
Limbo,2435321,1997807,437514,,8300000
Management,2434658,934658,1500000,3840855,00000
Tough Enough,2433722,2433722,00000,,00000
Read My Lips,2431453,1359133,1072320,,00000
Truck,2431064,00000,2431064,,00000
The Grace Card,2430735,2430735,00000,,200000
Otra pelicula de huevos y un pollo,2430452,00000,2430452,,00000
Under the Volcano,2428653,2428653,00000,,00000
Tinker Bell,2427167,00000,2427167,66541562,00000
Pyaar Ka Punchnama,2426641,00000,2426641,,00000
Hamlet,2419669,1577287,842382,,2000000
Moonlight and Valentino,2418013,2418013,00000,,00000
Torremolinos 73,2416771,87385,2329386,,00000
The Stupids,2415593,2415593,00000,,00000
Flirting,2415396,2415396,00000,,00000
2015 Oscar Shorts,2412493,2412493,00000,,00000
What Just Happened,2412123,1090947,1321176,,27000000
The Devil's Double,2406666,1361512,1045154,,19100000
Kitchen Stories,2406347,349315,2057032,,00000
Nannerl la soeur de Mozart,2404639,707885,1696754,,4500000
Questa notte è ancora nostra,2403049,00000,2403049,,00000
Renaissance,2401413,70644,2330769,,18000000
It's a Free World...,2397451,06389,2391062,,00000
Dasepo Naughty Girls,2396619,00000,2396619,,00000
Kalifornia,2395231,2395231,00000,,00000
Backbeat,2392599,2392599,00000,,00000
Modern Boy,2391854,00000,2391854,,00000
Solo Album,2390704,00000,2390704,,00000
King of New York,2389850,2389850,00000,,00000
I'm in Love with a Church Girl,2387730,2387730,00000,647005,00000
The Twilight Saga: Twilight/New Moon Combo,2385237,2385237,00000,,00000
The Basketball Diaries,2381087,2381087,00000,,00000
L'âge des ténèbres,2379375,1491525,887850,,00000
Table for Five,2378738,2378738,00000,,00000
Wildfire: Feel The Heat,2378388,2378388,00000,,00000
The Proposition,2377528,1622381,755147,,00000
The Dancer Upstairs,2374732,2374732,00000,,00000
Love is Strange,2374421,2262555,111866,67142,00000
Bamboozled,2373937,2185266,188671,,10000000
A Little Sex,2370376,2370376,00000,,00000
Margot at the Wedding,2367775,1958977,408798,,00000
Wild Bill,2363472,2169373,194099,,00000
Dancing at Lughnasa,2361632,2361632,00000,,00000
Farewell to the King,2361132,2361132,00000,,00000
The Amateur,2358271,2358271,00000,,00000
2014 Oscar Shorts,2357890,2357890,00000,,00000
In the Name of Love,2357703,00000,2357703,,00000
Cemetery Junction,2357547,00000,2357547,,00000
Blackfish,2354875,2073582,281293,1094681,00000
Extinction,2350695,00000,2350695,,00000
Teeth,2350641,347578,2003063,,2000000
Fright Night II,2350289,2350289,00000,,00000
At Close Range,2347000,2347000,00000,,00000
Blind Fury,2345628,2345628,00000,,00000
Gabriela,2335352,2335352,00000,,50000
5 Flights Up,2334287,1020921,1313366,357937,00000
Meru,2334228,2334228,00000,,00000
"Secret of the Magic Gourd, The",2327800,00000,2327800,,00000
Last Orders,2326407,2326407,00000,,12000000
Quelque chose à te dire,2326099,00000,2326099,,00000
King Naresuan 4,2323926,00000,2323926,,00000
Seefood,2323543,00000,2323543,,00000
Branded,2322630,353513,1969117,,00000
Love Crimes,2320217,2320217,00000,,00000
East-West,2319726,2319726,00000,,00000
"White Hunter, Black Heart",2319124,2319124,00000,,00000
Return,2318779,00000,2318779,,00000
The Man Who Wasn't There,2315505,2315505,00000,,00000
Paan Singh Tomar,2315251,40311,2274940,,00000
Shanghai Surprise,2315000,2315000,00000,,17000000
Des vents contraires,2312123,00000,2312123,,00000
8 Films to Die For,2310680,2310680,00000,,00000
JCVD,2309944,470691,1839253,,00000
A Good Man in Africa,2308390,2308390,00000,,00000
His Secret Life,2308298,215339,2092959,,00000
"Merry Christmas, Mr. Lawrence",2306560,2306560,00000,,00000
Sleeping with Other People,2304620,814775,1489845,,00000
Kokoda,2301966,00000,2301966,,00000
The Navigators,2301940,01940,2300000,,00000
Hav Plenty,2301777,2301777,00000,,650000
The Day of the Dolphin,2300000,2300000,00000,,00000
To The Shores of Tripoli,2300000,2300000,00000,,00000
Repo Man,2300000,2300000,00000,,1500000
Hell Night,2300000,2300000,00000,,00000
Sàidékè balái,2299720,00000,2299720,,00000
Windhorse,2297017,2297017,00000,,00000
"Man, Woman and Child",2296853,2296853,00000,,00000
Jude,2296297,407072,1889225,,00000
The Pillow Book,2293037,2293037,00000,,00000
Demandez la Permission aux Enfants,2292298,00000,2292298,,00000
Nobody Knows,2291229,683575,1607654,,00000
Snowriders 2,2287639,2287639,00000,,00000
The Yards,2282710,882710,1400000,,20000000
Curious George 2: Follow That Monkey,2281905,00000,2281905,10800587,00000
The Nasty Girl,2281569,2281569,00000,,00000
FUR: An Imaginary Portrait of Diane Arbus,2281089,223202,2057887,,16800000
42nd Street,2281000,1438000,843000,,439000
Ma Vie en Rose,2280573,2280573,00000,,00000
Noises Off...,2280148,2280148,00000,,00000
Pecker,2279807,2279807,00000,,00000
Nomads,2278264,2278264,00000,,00000
Gidarida Michyeo,2277281,00000,2277281,,00000
Escanaba in Da Moonlight,2276406,2276406,00000,,00000
Showdown in Little Tokyo,2275557,2275557,00000,,8000000
The East,2274649,2274649,00000,194812,00000
Dior and I,2274016,1028953,1245063,,00000
"No Retreat, No Surrender",2273045,2273045,00000,,00000
La doublure,2272329,2272329,00000,,00000
Casino Jack,2272186,2039869,232317,,12500000
Jem and the Holograms,2270096,2184640,85456,,00000
Texasville,2268181,2268181,00000,,00000
Sleepwalk With Me,2266066,2266066,00000,,00000
Utomlyonnye solntsem,2265414,2265414,00000,,00000
My Love,2264968,00000,2264968,,00000
Gilda Live,2261507,2261507,00000,,00000
Swindler in My Mom's House,2260734,00000,2260734,,00000
Sing,2260616,2260616,00000,,00000
Touch of Evil,2257349,2237659,19690,,00000
DysFunkTional Family,2255000,2255000,00000,,3000000
Bill Cunningham New York,2254254,1510026,744228,,00000
Life in a... Metro,2253352,150212,2103140,,00000
Clay Pigeons,2253139,1789892,463247,,8000000
The Dish,2252970,2252970,00000,,00000
It Happened at the World's Fair,2250000,2250000,00000,,00000
My All-American,2246000,2246000,00000,,20000000
Neil Young: Heart of Gold,2238644,1828069,410575,11372774,00000
2 States,2238175,2238175,00000,,00000
What's Your Raashee?,2232500,257868,1974632,,00000
Everyday I Love You,2232350,00000,2232350,,00000
Vincent & Theo,2231274,2231274,00000,,00000
The Squeeze,2228951,2228951,00000,,00000
The Eye of the Storm,2226888,83566,2143322,,00000
It's All Gone Pete Tong,2226603,120620,2105983,,2000000
Le Week-End,2225098,2225098,00000,45406,00000
Don,2223961,2223961,00000,,00000
Metallica: Some Kind of Monster,2223844,1222708,1001136,,00000
Smilla's Sense of Snow,2221994,2221994,00000,,35000000
Apollo 13 (IMAX),2219202,1759075,460127,,00000
Def by Temptation,2218579,2218579,00000,,00000
Bunteu,2217531,00000,2217531,,00000
Leprechaun 2,2217237,2217237,00000,,00000
Generation P,2214954,00000,2214954,,00000
Hing dai,2213095,00000,2213095,,00000
Sleuth,2212891,342895,1869996,,00000
Two Girls and a Guy,2208051,1950218,257833,,1000000
Downtown,2205486,2205486,00000,,00000
Valentino: The Last Emperor,2204738,1755134,449604,,00000
The Whistleblower,2203654,1120914,1082740,,00000
If Lucy Fell,2202580,2202580,00000,,00000
Once Were Warriors,2201126,2201126,00000,,00000
Lawnmower Man 2: Beyond Cyberspace,2200664,2200664,00000,,00000
Vivere in Pace,2200000,2200000,00000,,00000
Windows,2200000,2200000,00000,,00000
The Molly Maguires,2200000,2200000,00000,,11000000
The Imposters,2197921,2197921,00000,,00000
O Jerusalem,2195669,234480,1961189,,00000
Chinese Box,2195190,2195190,00000,,00000
Innocence,2194919,2194919,00000,,00000
Double Dragon,2194780,2194780,00000,,00000
Dod sno,2194020,46742,2147278,,800000
Cinderella,2185663,00000,2185663,,00000
Bird,2181286,2181286,00000,,00000
Buffalo '66,2180752,2180752,00000,,1500000
The Paperboy,2176376,677200,1499176,3341977,00000
Once Upon a Time... When We Were Colored,2174060,2174060,00000,,00000
No Problem,2172821,00000,2172821,,00000
’71,2170847,1270847,900000,,00000
Tesis Sobre un Homicidio,2165848,00000,2165848,,00000
A Dog of Flanders,2165637,2165637,00000,,7000000
Gulaal,2164821,00000,2164821,,00000
"Paris, Texas",2164507,2164507,00000,,00000
Wilde,2157701,2157701,00000,,00000
Scenes from the Class Struggle in Beverly Hills,2156471,2156471,00000,,00000
The Endless Summer 2,2155385,2155385,00000,,00000
Shadow Conspiracy,2154540,2154540,00000,,45000000
Un dimanche à la campagne,2153717,2153717,00000,,00000
Grave Encounters,2151887,00000,2151887,,2000000
Mysterious Skin,2148548,713240,1435308,,00000
Meatballs III,2147228,2147228,00000,,00000
Tarzan and the Lost City,2147114,2147114,00000,,00000
The Saratov Approach,2146998,2146998,00000,,00000
Xingu,2145834,00000,2145834,,00000
Mrs. Parker and the Vicious Circle,2144667,2144667,00000,,00000
2013 Oscar Shorts,2142342,2142342,00000,,00000
Now is Good,2141436,00000,2141436,,500000
Austenland,2137573,2137573,00000,,00000
Morgan Stewart's Coming Home,2136381,2136381,00000,,00000
Jinxed!,2133621,2133621,00000,,00000
Ran,2132974,2132974,00000,,00000
Dinosaurs: Giants of Patagonia,2130465,00000,2130465,,00000
Tie saam gok,2129774,00000,2129774,,00000
Roger Waters the Wall,2126962,00000,2126962,,00000
Krrish 3,2123333,2123333,00000,,00000
Videodrome,2120439,2120439,00000,,5952000
The Nutcracker,2119994,2119994,00000,,19000000
Personal Best,2119003,2119003,00000,,00000
Gloria,2110357,2110357,00000,79432,00000
Roar,2110050,2110050,00000,,17000000
Who Dares Wins,2108197,2108197,00000,,00000
Piku,2105759,1801806,303953,,00000
Xing kong,2105079,00000,2105079,,00000
The Pursuit of D.B. Cooper,2104164,2104164,00000,,12000000
Another Earth,2102779,1321194,781585,,175000
Faithful,2101580,2101580,00000,,13000000
King Richard and the Crusaders,2100000,2100000,00000,,00000
Conquest,2100000,2100000,00000,,00000
The Meerkats,2100000,00000,2100000,,00000
State Property,2099719,2099719,00000,,00000
Guru,2096000,2096000,00000,,00000
Kika,2093000,2093000,00000,,00000
A Month by the Lake,2092272,2092272,00000,,00000
Heathcliff: The Movie,2091504,2091504,00000,,00000
It Came From Hollywood,2091037,2091037,00000,,00000
Trailer Park Boys 3: Don’t Legalize It,2090607,2090607,00000,,00000
Dabbe,2090121,00000,2090121,,00000
15 ans et demi,2089547,00000,2089547,,00000
Everything is Illuminated,2088946,1705595,383351,,00000
Just Tell Me What You Want,2086905,2086905,00000,,00000
The Diary of a Teenage Girl,2086697,1477002,609695,,00000
La lengua de las mariposas,2086098,2086098,00000,,00000
Kill Your Darlings,2084815,1029949,1054866,,00000
The Daytrippers,2084559,2084559,00000,,00000
Conte d'automne,2082061,2082061,00000,,00000
Screwballs,2082000,2082000,00000,,00000
Mr. Deeds Goes To Town,2080000,2080000,00000,,00000
Faces in the Crowd,2078672,00000,2078672,,00000
He'arat Shulayim,2078560,2007451,71109,,00000
Strangers with Candy,2077844,2072645,05199,,2000000
The Sheltering Sky,2075084,2075084,00000,,00000
Ayurveda: Art of Being,2066892,16892,2050000,,300000
Carlitos y el campo de los seños,2064565,00000,2064565,,00000
Ravenous,2062406,2062406,00000,,12000000
Youth Without Youth,2061804,239495,1822309,,00000
Bollywood/Hollywood,2056380,1491083,565297,,00000
Man of Tai Chi,2054941,00000,2054941,313590,00000
Pelle erobreren,2053931,2053931,00000,,00000
Turtle Diary,2053364,2053364,00000,,00000
Manon des sources,2051777,2051777,00000,,00000
Jacknife,2049769,2049769,00000,,00000
Trick,2049595,2049595,00000,,00000
Beyond the Mat,2047570,2047570,00000,,500000
Roadside Romeo,2046090,55202,1990888,,2000000
Poongsan,2045774,00000,2045774,,00000
Fauteils d'orchestre,2044858,2044858,00000,,00000
Sexo Com Amor?,2044777,00000,2044777,,00000
Rooftops,2043889,2043889,00000,,00000
Viruddh,2043726,322753,1720973,,00000
El Mariachi,2041928,2040920,01008,,07000
Cafe Solo o Con Ellas,2040604,00000,2040604,,00000
We Don't Live Here Anymore,2037545,2037545,00000,,00000
The Krays,2035562,2035562,00000,,00000
Snowriders,2035470,2035470,00000,,00000
Mom and Dad Save the World,2034470,2034470,00000,,00000
Gate II,2032973,2032973,00000,,00000
Besieged,2032621,2032621,00000,,00000
Le Grand Alibi,2032094,00000,2032094,,00000
Clown,2031400,00000,2031400,,00000
Mallrats,2028211,2028211,00000,,6100000
Dangerously Close,2026765,2026765,00000,,00000
Hello,2026753,00000,2026753,,00000
The Work and the Glory: American Zion,2024854,2024854,00000,,6500000
Etiquette for Mistresses,2024650,00000,2024650,,00000
Storytelling,2024522,912442,1112080,,00000
Winter People,2023282,2023282,00000,,00000
The Broken Hearts Club: A Romantic Comedy,2022442,1744858,277584,,1000000
Billy's Hollywood Screen Kiss,2020700,2020700,00000,,00000
Three Seasons,2019237,2019237,00000,,00000
A Guide to Recognizing Your Saints,2016139,516139,1500000,,00000
Rad,2015882,2015882,00000,,00000
Los Pelayos,2015219,00000,2015219,,00000
Night on Earth,2015000,2015000,00000,,00000
San suk si gin,2013340,00000,2013340,,00000
"Bon Voyage, Charlie Brown (and Don't Come Back!)",2013193,2013193,00000,,00000
Sur Le Seuil,2013052,2013052,00000,,2500000
Swades,2012709,1223240,789469,,00000
The Amateurs,2011497,2011497,00000,,00000
Better Than Chocolate,2011254,2011254,00000,,00000
Big Bully,2010557,2010557,00000,,00000
Welcome Back,2010478,1388365,622113,,00000
Hum Saath-Saath Hain,2005094,2005094,00000,,00000
Nez Rouge,2004814,2004814,00000,,00000
Lezioni di Cioccolato 2,2002675,00000,2002675,,00000
Nemesis,2001124,2001124,00000,,00000
Shut Up and Sing,2000043,1215045,784998,,00000
Bad Lieutenant,2000022,2000022,00000,,00000
The Wrong Man,2000000,2000000,00000,,1200000
Wilson,2000000,2000000,00000,,5200000
Foolin' Around,2000000,2000000,00000,,00000
Sharks' Treasure,2000000,2000000,00000,,00000
Date With an Angel,2000000,2000000,00000,,00000
The Hand,2000000,2000000,00000,,00000
"Farewell, My Lovely",2000000,2000000,00000,,00000
Can't Stop the Music,2000000,2000000,00000,,20000000
Che!,2000000,2000000,00000,,00000
She Done Him Wrong,2000000,2000000,00000,,200000
Playing for Keeps,2000000,2000000,00000,,35000000
I was a Teenage Werewolf,2000000,2000000,00000,,00000
The Care Bears Adventure in Wonderland,2000000,2000000,00000,,00000
Return to the Blue Lagoon,2000000,2000000,00000,,11000000
Kansas,2000000,2000000,00000,,00000
et Dieu… Crea la Femme,2000000,2000000,00000,,00000
Pikovaya dama. Chyornyy obryad,1996552,00000,1996552,,00000
Steak,1995149,00000,1995149,,00000
Married To It,1989059,1989059,00000,,00000
The Art of Getting By,1989035,1430241,558794,,4000000
Dr. Cabbie,1986209,1986209,00000,,00000
Shortbus,1985292,1985292,00000,,2000000
Surviving Picasso,1985001,1985001,00000,,00000
Red State,1983596,1065429,918167,,4000000
Cake,1982489,1951776,30713,,00000
Taal,1980398,1980398,00000,,00000
Zero Effect,1980338,1980338,00000,,5000000
Rich in Love,1978522,1978522,00000,,00000
O... &Ccedil;ocuklari,1973088,00000,1973088,,00000
M,1972914,00000,1972914,,00000
Osama,1971479,1127331,844148,,500000
Felicia's Journey,1970268,824295,1145973,,15000000
Endless Winter,1966454,1966454,00000,,00000
Yume,1963207,1963207,00000,,00000
Breaking Wind,1961193,00000,1961193,,00000
All the Boys Love Mandy Lane,1960521,00000,1960521,,750000
The Source,1956822,362357,1594465,,00000
Tamasha,1954248,1413443,540805,,00000
Crazy in Alabama,1954202,1954202,00000,,15000000
Cecil B. Demented,1953882,1276984,676898,,10000000
The Clan of the Cave Bear,1953732,1953732,00000,,15000000
Love Field,1949148,1949148,00000,,00000
Bezerra de Menezes - O Diário de um Espírito,1948185,00000,1948185,,00000
Chance Pe Dance,1945716,168643,1777073,,00000
La chambre bleue,1945420,260441,1684979,,1400000
Broken English,1944150,956919,987231,,00000
Jag är Ingrid,1942847,29568,1913279,,00000
"Hey There, It's Yogi Bear",1940903,1940903,00000,,00000
"Goodbye, Lover",1940299,1940299,00000,,00000
Singh Is Bliing,1939033,919095,1019938,,00000
Spellbinder,1938049,1938049,00000,,00000
Cadence,1935475,1935475,00000,,00000
Electric Dreams,1932663,1932663,00000,,00000
Erik the Viking,1932642,1932642,00000,,00000
Afutâ suk$ucirc;ru,1930109,00000,1930109,,00000
Infinitely Polar Bear,1925332,1430655,494677,,00000
V/H/S,1925329,100345,1824984,,00000
Huozhe,1923899,1923899,00000,,00000
Paradise Road,1921471,1921471,00000,,00000
Titus,1921350,1921350,00000,,00000
Last Days,1920616,454711,1465905,,00000
Kung Fu Hip-Hop,1920400,00000,1920400,,00000
Communion,1919000,1919000,00000,,00000
Fresa y chocolate,1918424,1918424,00000,,00000
Warning Sign,1918117,1918117,00000,,00000
Colpo d'occhio,1917707,00000,1917707,,00000
"Kiss Me, Guido",1916898,1916898,00000,,00000
Thumbsucker,1915591,1325073,590518,,4000000
Old Fashioned,1914090,1914090,00000,567067,00000
State of Grace,1911542,1911542,00000,,00000
Je Deteste les Enfantes des Autres,1909603,00000,1909603,,00000
Fly Daddy,1904386,00000,1904386,,00000
Les herbes folles,1903952,403952,1500000,,14000000
Alter Ego,1901495,00000,1901495,,00000
Yao a yao yao dao waipo qiao,1900504,1900504,00000,,00000
La Pianiste,1900282,1900282,00000,,00000
Mass Appeal,1900000,1900000,00000,,00000
"Easy Come, Easy Go",1900000,1900000,00000,,00000
I Wanna Hold Your Hand,1900000,1900000,00000,,00000
Tobacco Road,1900000,1900000,00000,,00000
Game of Thrones: The IMAX Experience,1896092,1896092,00000,,00000
Permanent Record,1893000,1893000,00000,,00000
The Mighty Macs,1891936,1891936,00000,,7000000
"Sans Arme, Ni Haine, Ni Violence",1891002,00000,1891002,,00000
Masterminds,1890472,1890472,00000,,00000
The Breed,1888604,00000,1888604,,00000
The Night We Never Met,1884814,1884814,00000,,00000
Cop,1884315,1884315,00000,,00000
Dans une galaxie pres de chez vous 2,1883999,1883999,00000,,00000
Vibes,1883811,1883811,00000,,00000
Why We Fight,1880863,1880863,00000,,00000
The Slugger's Wife,1878000,1878000,00000,,00000
Only Lovers Left Alive,1876685,1876685,00000,1197505,00000
Between Love and Hate,1876545,00000,1876545,,00000
Poli Opposti,1874768,00000,1874768,,00000
Kaguyahime no monogatari,1874746,1506975,367771,893434,00000
Khichdi The Movie,1874285,00000,1874285,,00000
"Ce soir, je dors chez toi",1871691,00000,1871691,,00000
Qian bu gou yong II,1870552,00000,1870552,,00000
Meek's Cutoff,1869928,977772,892156,,2000000
11'09''01 - September 11,1868798,126694,1742104,,00000
Bitter Moon,1862000,1862000,00000,,00000
Re-Animator,1861026,1861026,00000,,00000
Ice Bar,1857511,00000,1857511,,00000
Marie,1856840,1856840,00000,,00000
Dao Jian Xiao,1856397,47897,1808500,,00000
Henry Poole Is Here,1852777,1835293,17484,,00000
Miss Firecracker,1852655,1852655,00000,,00000
Salaam-e-Ishq (A Tribute to Love),1852050,1852050,00000,,00000
Ex with Benefits,1851902,00000,1851902,,00000
Chuzhaya,1849944,00000,1849944,,00000
Who Killed the Electric Car?,1849392,1678874,170518,,1000000
Gerry,1844754,1844754,00000,,00000
Harrison's Flowers,1843570,1843570,00000,,00000
High Art,1835565,1835565,00000,,00000
Roger Dodger,1833349,1260761,572588,,00000
Crooked Arrows,1832541,1832541,00000,,00000
Poison Ivy,1829804,1829804,00000,,00000
Floride,1828809,00000,1828809,,00000
Tu Xia Chuan Qi,1828400,00000,1828400,,12000000
Les Randonneurs à Saint-Tropez,1823846,00000,1823846,,00000
The Butcher Boy,1822193,1822193,00000,,00000
Tusk,1821983,1821983,00000,108961,3000000
The Buddy System,1820049,1820049,00000,,00000
Wonderland,1819527,413595,1405932,,00000
Carny,1817720,1817720,00000,,00000
Bossa Nova,1816792,1816792,00000,,00000
Miss Gold Digger,1816571,00000,1816571,,00000
A Man Who Was Superman,1814480,00000,1814480,,00000
Ddeugeoun-geosi joh-a,1811549,00000,1811549,,00000
Breaking In,1811086,1811086,00000,,00000
The Color of Paradise,1810145,1810145,00000,,00000
N'sync: Bigger than Live,1808679,1808679,00000,,00000
Eye See You,1807990,79161,1728829,,55000000
O'Horten,1802232,302232,1500000,,00000
Damaged Lives,1800000,1800000,00000,,00000
Kid Galahad,1800000,1800000,00000,,00000
Maya the Bee,1798251,00000,1798251,102025,00000
Hurlyburly,1796328,1796328,00000,,00000
La Vie Après L'Amour,1795758,1795758,00000,,00000
Delicatessen,1794187,1794187,00000,,00000
Tune in Tomorrow,1794000,1794000,00000,,00000
Stormy Monday,1791328,1791328,00000,,00000
Code 46,1788324,197148,1591176,,7500000
The Oyster Farmer,1786846,14470,1772376,,00000
Venus and Mars,1785737,00000,1785737,,00000
Jai Veeru,1784639,00000,1784639,,00000
The Man Who Cried,1783331,739583,1043748,,00000
The Mangler,1781000,1781000,00000,,00000
The Notorious Bettie Page,1779570,1415082,364488,,00000
Chalet Girl,1779517,01610,1777907,,00000
The Dangerous Lives of Altar Boys,1779284,1779284,00000,,12000000
The Worst Guy Ever,1776916,00000,1776916,,00000
Washington Square,1775644,1775644,00000,,00000
Mo-bi-dik,1775209,00000,1775209,,00000
Lemale et ha'halal,1774639,1774639,00000,,00000
Awake: The Life of Yogananda,1773653,1511750,261903,270486,00000
Big Stan,1770677,00000,1770677,,00000
Naked,1769000,1769000,00000,,00000
Leviafan,1766860,1092800,674060,165310,00000
A Better Life,1766372,1759252,07120,,10000000
99 Homes,1765881,1411927,353954,,00000
Department,1765771,00000,1765771,,00000
Murderball,1765708,1523883,241825,,350000
The Silence,1765607,1765607,00000,,00000
Main Hoon Na,1765346,1722453,42893,,00000
Boy A,1760943,113662,1647281,,00000
J'Veux Pas Que Tu T'en Ailles,1760168,00000,1760168,,00000
A Soldier's Daughter Never Cries,1759596,1759596,00000,,00000
Teng Nong Khon Maha-Hia,1759123,00000,1759123,,00000
Cookie,1755480,1755480,00000,,00000
Flipped,1755212,1755212,00000,,14000000
Carnosaur,1753979,1753979,00000,,00000
Koi… Mil Gaya,1752408,680979,1071429,,00000
Vanya on 42nd Street,1746000,1746000,00000,,00000
The Messenger,1744952,1109660,635292,,6500000
Carman: The Champion,1743863,1743863,00000,,00000
The Debut,1743570,1743570,00000,,00000
The Horror Show,1738897,1738897,00000,,00000
Simon,1738379,03771,1734608,,1300000
Comme une image,1736499,1736499,00000,,00000
Le Deuxième souffle,1735359,00000,1735359,,00000
The Dream Life of Angels,1734831,1734831,00000,,00000
"Che, Part 1: The Argentine",1733532,1733532,00000,,00000
Little Nikita,1733070,1733070,00000,,00000
The Big Town,1733017,1733017,00000,,00000
Sunday,1732665,00000,1732665,,00000
The Rosary Murders,1730337,1730337,00000,,00000
The Waterdance,1723319,1723319,00000,,00000
Mon Fils à Moi,1723084,00000,1723084,,00000
Mortuary,1722738,1722738,00000,,00000
Naraka 19,1720493,00000,1720493,,00000
Link,1720450,1720450,00000,,00000
The Forbidden Dance,1719538,1719538,00000,,00000
El abrazo partido,1717243,189836,1527407,,00000
Gekijoban Saraba Kamen Raida Den'o Fainaru Kauntodaun,1716850,00000,1716850,,00000
Tumbleweeds,1715108,1277188,437920,,312000
Girl on the Bridge,1713995,1713995,00000,,00000
Selon Charlie,1713311,00000,1713311,,00000
To Sir With Love,1712029,00000,1712029,,00000
Death Wish V: The Face of Death,1711424,1711424,00000,,00000
Sweet Land,1706325,1706325,00000,,00000
"Men, Women and Children",1705908,705908,1000000,29582,00000
What's Cooking,1705143,1045899,659244,,00000
Lady in White,1705139,1705139,00000,,4700000
Derzkie Dni,1703910,00000,1703910,,00000
The Life and Times of Hank Greenberg,1703901,1703901,00000,,00000
A Home of Our Own,1703282,1703282,00000,,00000
2012 Oscar Shorts,1702415,1702415,00000,,00000
Best of the Best,1700000,1700000,00000,,00000
The Kid Stays in the Picture,1699809,1434436,265373,,00000
Boxing Helena,1699744,1699744,00000,,00000
Une vieille maîtresse,1697774,785671,912103,,00000
The Bridge of San Luis Rey,1696765,49981,1646784,,24000000
Saint Ralph,1695126,795126,900000,,5200000
Go Go 70's,1693645,00000,1693645,,00000
El Vacilón: The Movie,1693256,1693256,00000,,00000
Ararat,1693000,1693000,00000,,15500000
Suicide Kings,1692872,1692872,00000,,00000
State Property 2,1691706,1691706,00000,,00000
Meet the Patels,1691439,1691439,00000,,00000
Jesus' Son,1687548,1282084,405464,,2500000
Texas Killing Fields,1686991,45470,1641521,,00000
Steel,1686429,1686429,00000,,16000000
Therese Desqueyroux,1684621,226555,1458066,,00000
Combustion,1683711,00000,1683711,,00000
Kung Fu Tootsie,1682173,00000,1682173,,00000
Race the Sun,1681685,1681685,00000,,00000
Matewan,1680358,1680358,00000,,00000
All Inclusive,1677146,00000,1677146,,00000
Bring on the Night,1675689,1675689,00000,,00000
The Legend of Johnny Lingo,1673997,1673997,00000,,00000
Priest,1671612,00000,1671612,,00000
Tim's Vermeer,1670806,1670806,00000,,00000
The Lady,1669231,135985,1533246,,00000
I Shot Andy Warhol,1667299,1667299,00000,,00000
Talento de Barrio,1667294,1667294,00000,,00000
Liam,1665705,1016021,649684,,00000
Breakaway,1664792,1481735,183057,,00000
Subway,1663296,390659,1272637,,2000000
Chillar Party,1662597,06330,1656267,,00000
Les doigts croches,1662485,1662485,00000,,00000
Factory Girl,1661464,1661464,00000,,7000000
"The Book of Mormon Movie, Volume 1: The Journey",1660865,1660865,00000,,2000000
Out on a Limb,1659542,1659542,00000,,00000
Shingeki no kyojin: Guren no yumiya,1659387,00000,1659387,,00000
More Than Blue,1659016,00000,1659016,,00000
Asterix-Le Domaine des dieux,1656287,1656287,00000,,00000
Prick Up Your Ears,1654743,1654743,00000,,00000
Even Cowgirls Get the Blues,1649796,1649796,00000,,00000
Festen,1647780,1647780,00000,,1300000
The Winter's Tale,1647708,00000,1647708,,00000
Hector and the Search for Happiness,1646814,1124445,522369,339464,00000
Marci X,1646664,1646664,00000,,20000000
Nate and Hayes,1643022,1643022,00000,,00000
It's a Wonderful Afterlife,1642939,00000,1642939,,10000000
Spider,1641788,1641788,00000,,10000000
Body Rock,1639127,1639127,00000,,00000
Gun Shy,1638202,1638202,00000,,10000000
Big Game,1637947,24752,1613195,1339588,00000
Actrices,1637310,00000,1637310,,00000
Flammen og Citronen,1635241,148089,1487152,,9000000
3 hommes et un couffin,1634389,1634389,00000,,00000
The Two Faces of January,1632152,507463,1124689,51306,00000
The Christmas Candle,1632000,1632000,00000,1119045,7000000
A Million,1631439,00000,1631439,,00000
Den skaldede frisør,1631306,1631306,00000,120447,00000
Secuestro Express,1629473,302256,1327217,,00000
Bacheha-Ye aseman,1628579,933933,694646,,180000
Brain Dead,1627955,1627955,00000,,00000
Bhaag Milkha Bhaag,1626289,1626289,00000,,00000
L'attentat,1625707,1625707,00000,,00000
Heist,1620834,50136,1570698,,15000000
Home,1620056,00000,1620056,,12000000
Vertical Reality,1619747,1619747,00000,,00000
Barbie and the Secret Door,1619644,00000,1619644,6444214,00000
Session 9,1619602,378176,1241426,,1500000
Standing in the Shadows of Motown,1615732,1615732,00000,,00000
Io non ho paura,1615118,1615118,00000,,00000
Tofu Kozo Sugoroku-dochu Furidashi,1614401,00000,1614401,,00000
Oye Lucky! Lucky Oye!,1612746,80037,1532709,,00000
The Blue Butterfly,1610194,1610194,00000,,10400000
It Might Get Loud,1610163,1610163,00000,,00000
The Disappearance of Alice Creed,1605139,166980,1438159,,00000
Cairo Time,1603616,1603616,00000,,00000
Astérix et Obélix contre César,1601481,1601481,00000,,00000
L-o-v-e,1601237,00000,1601237,,00000
Dogtown and Z-Boys,1600566,1293295,307271,,400000
Parnell,1600000,1600000,00000,,00000
Jonathan Livingston Seagull,1600000,1600000,00000,,00000
Double Trouble,1600000,1600000,00000,,00000
La Florida,1600000,1600000,00000,,00000
The Prince and the Showgirl,1600000,1600000,00000,,00000
The Wolfpack,1599486,1301696,297790,16013,00000
Chasers,1596700,1596700,00000,,00000
Holy Daddy,1595545,00000,1595545,,00000
Triangle,1595168,00000,1595168,,12000000
Rhyme & Reason,1591687,1591687,00000,,00000
I Am,1591034,1591034,00000,,00000
Midnight Meat Train,1590246,73548,1516698,,15000000
The Concert,1588999,926009,662990,,00000
Romance,1585642,1585642,00000,,00000
Making Mr. Right,1584970,1584970,00000,,00000
Project Nim,1583533,411184,1172349,,00000
Seethamma Vakitlo Sirimalle Chettu,1582476,1582476,00000,,00000
Student Bodies,1582148,1582148,00000,,00000
Ju Dou,1581618,1581618,00000,,00000
Solarbabies,1579260,1579260,00000,,00000
Nine Lives,1578830,478830,1100000,,00000
Cafe de flore,1574881,1574881,00000,,00000
"One Piece: Episode of Chopper: Bloom in the Winter, Miracle Sakura",1574571,00000,1574571,,00000
Mole Zhuangyuan Bingshiji,1572300,00000,1572300,,00000
Dus Kahaniyaan,1571158,219071,1352087,,00000
Short Term 12,1569540,1013100,556440,473712,00000
Heavenly Bodies,1567386,1567386,00000,,00000
Three Fellas,1566972,00000,1566972,,00000
The Woodsman,1566812,1566812,00000,,00000
Bruc,1566101,00000,1566101,,00000
Weekend,1562940,469947,1092993,,190000
Nicholas Nickleby,1562800,1562800,00000,,10000000
Another Woman,1562749,1562749,00000,,00000
De Club van Sinterklaas & De Verdwenen Schoentjes,1561665,00000,1561665,,00000
A Late Quartet,1561577,1561577,00000,,00000
A Handful of Dust,1560700,1560700,00000,,00000
Walking and Talking,1559610,1231303,328307,,1000000
"Bless Me, Ultima",1559556,1559556,00000,,00000
Persecuted,1557494,1557494,00000,78074,00000
Black Sea,1555333,1171559,383774,657791,00000
Truly Madly Deeply,1554742,1554742,00000,,00000
Stan Helsing: A Parody,1553556,00000,1553556,,14000000
Puli,1553385,00000,1553385,,00000
El Bufalo de la Noche,1553198,00000,1553198,,00000
Late Marriage,1551470,1551470,00000,,00000
Chocolate: Deep Dark Secrets,1549000,49000,1500000,,1000000
"Dédé, à travers les brumes",1548858,1548858,00000,,00000
Two Moon Junction,1547397,1547397,00000,,00000
Fed Up,1546228,1538898,07330,867167,00000
The Bay,1545308,30668,1514640,,00000
The Statement,1545064,765637,779427,,27000000
Withnail & I,1544889,1544889,00000,,00000
One False Move,1543000,1543000,00000,,00000
Rampart,1540340,969239,571101,1651663,00000
Year of the Dog,1540141,1540141,00000,,00000
Barbie in Princess Power,1539187,00000,1539187,3331527,00000
Three for the Road,1539000,1539000,00000,,00000
A Hard Day's Night,1537860,1537860,00000,,560000
Blonde Ambition,1537479,06422,1531057,,10000000
Testament,1537122,1537122,00000,,00000
Eros,1535685,188248,1347437,,00000
Carne trémula,1535558,1535558,00000,,00000
The Gingerbread Man,1534569,1534569,00000,,00000
La Jeune Fille et les Loups,1533689,00000,1533689,,00000
National Theatre Live: Of Mice and Men,1532726,00000,1532726,,00000
Requiem,1531921,09600,1522321,,00000
Tacones lejanos,1530941,1530941,00000,,00000
Ouija,1530776,00000,1530776,,00000
13 Semester,1528815,00000,1528815,,00000
"Deux jours, une nuit",1528288,1423552,104736,22405,00000
The Hottie and the Nottie,1527696,27696,1500000,,00000
A Midnight Clear,1526697,1526697,00000,,00000
Efter brylluppet,1526359,1526359,00000,,00000
Girlfight,1523941,1523941,00000,,00000
By the Sea,1523160,498379,1024781,,20000000
Les Liens du sang,1523036,00000,1523036,,00000
The Stepfather 2,1519796,1519796,00000,,00000
Safe Passage,1517700,1517700,00000,,00000
That Sugar Film,1516765,03500,1513265,149232,00000
The Cove,1516214,869730,646484,,00000
Life is Sweet,1516000,1516000,00000,,00000
"I, The Jury",1515578,1515578,00000,,00000
Trade,1513388,214202,1299186,,12000000
L'Heure Zéro,1512047,00000,1512047,,00000
What We Did on Our Holiday,1510872,04200,1506672,17065,00000
Oscar and Lucinda,1508689,1508689,00000,,12500000
Burke & Hare,1507806,04833,1502973,,00000
Married Life,1506998,1506998,00000,,12000000
The Cottage,1504960,00000,1504960,,5000000
&Ccedil;ilgin Dersane Kampta,1504736,00000,1504736,,00000
Song of the Sea,1501065,857524,643541,1036414,00000
Time Changer,1500711,1500711,00000,,825000
Lion of the Desert,1500000,1500000,00000,,35000000
Lianna,1500000,1500000,00000,,00000
At Long Last Love,1500000,1500000,00000,,00000
Fun in Acapulco,1500000,1500000,00000,,00000
Atharintiki Daaredi,1500000,1500000,00000,,00000
Salvador,1500000,1500000,00000,,4500000
The Only Game in Town,1500000,1500000,00000,,00000
Harum Scarum,1500000,1500000,00000,,00000
Land of the Pharaohs,1500000,1500000,00000,,00000
M. Butterfly,1498795,1498795,00000,,00000
One More Chance,1497862,00000,1497862,,00000
Lore,1497544,970325,527219,,00000
A Dangerous Woman,1497222,1497222,00000,,00000
The Center of the World,1496037,1096037,400000,,00000
City of Industry,1495332,1495332,00000,,00000
A Love Story,1493728,00000,1493728,,00000
Gonzo: The Life and Work of Dr. Hunter S. Thompson,1492100,1252100,240000,,00000
Solo Quiero Caminar,1488707,00000,1488707,,00000
Zebrahead,1486300,1486300,00000,,00000
Josh and S.A.M.,1484404,1484404,00000,,00000
Misunderstood,1480510,1480510,00000,,00000
La Leyenda de la Nahuala,1479685,00000,1479685,,00000
La personne aux deux personnes,1477623,00000,1477623,,00000
Clockwise,1476356,1476356,00000,,00000
Rory O'Shea Was Here,1471229,23844,1447385,,00000
Fritt Vilt 2,1469096,00000,1469096,,00000
Sky Bandits,1468500,1468500,00000,,00000
Passe-Passe,1467549,00000,1467549,,00000
Finders Keepers,1467396,1467396,00000,,00000
She Hate Me,1465134,365134,1100000,,00000
Mister Johnson,1464000,1464000,00000,,00000
Trois couleurs: Blanc,1464000,1464000,00000,,00000
The Contract,1462668,00000,1462668,12658012,00000
Beyond a Reasonable Doubt,1461624,32917,1428707,,00000
Being Human,1461200,1461200,00000,,00000
Beautiful Thing,1460297,1460297,00000,,00000
Hors la loi,1459269,00000,1459269,,00000
Table No.21,1458966,00000,1458966,,00000
Kleiner Dodo,1458209,00000,1458209,,00000
The Other Woman,1455527,25423,1430104,1690477,00000
Under the Sand,1450106,1450106,00000,,00000
Happy Endings,1448701,1315701,133000,,00000
Shadow of the Wolf,1448640,1448640,00000,,00000
Tous les soleils,1448473,00000,1448473,,00000
Papa ou maman,1448066,00000,1448066,,00000
Northfork,1445140,1420578,24562,,1900000
Belizaire the Cajun,1444618,1444618,00000,,00000
Like a Virgin,1443386,00000,1443386,,00000
Masked Rider Kabuto,1441305,00000,1441305,,00000
Greenfingers,1439287,1439287,00000,,00000
Bubba Ho-Tep,1438368,1184656,253712,,1000000
Le chat du rabbin,1438223,04301,1433922,,00000
Blood Money,1437391,00000,1437391,,00000
Disconnect,1436862,1436862,00000,314425,00000
Carol,1436354,623251,813103,,00000
Down by Law,1436000,1436000,00000,,00000
Farinelli,1434847,1434847,00000,,00000
Ernest Rides Again,1433496,1433496,00000,,00000
No End In Sight,1433319,1433319,00000,,2000000
A Prayer for the Dying,1432687,1432687,00000,,00000
The Man from Elysian Fields,1431625,1431625,00000,,00000
In God's Hands,1431239,1431239,00000,,00000
Restrepo,1430603,1330894,99709,,00000
Bodyguard Na Liam 2,1429816,00000,1429816,,00000
I Hope They Serve Beer in Hell,1429453,1429299,00154,1954290,7000000
Garbo Talks,1427108,1427108,00000,,00000
Poulet aux prunes ,1426898,253705,1173193,,00000
La Herencia Valdemar,1426523,00000,1426523,,00000
Les Chansons d'Amour,1425827,103970,1321857,,00000
"Montana (Russia, 2008)",1424034,00000,1424034,,00000
Bleach: The Diamond Dust Rebellion,1423665,00000,1423665,,00000
Thr3e,1420418,1008849,411569,,2400000
American Flyers,1420355,1420355,00000,,00000
Kandahar,1418314,1418314,00000,,00000
Polytechnique,1418304,1418304,00000,,00000
Wendy and Lucy,1416046,865695,550351,,300000
Where the Truth Lies,1415656,872142,543514,,25000000
The Field,1414017,1414017,00000,,00000
Panic,1413577,767007,646570,,1000000
Vincere,1412865,619162,793703,,00000
Iris,1411315,1310678,100637,,00000
Nulevoy Kilometr,1410002,00000,1410002,,00000
Paheli (Puzzle),1409499,1409499,00000,,00000
Un heureux événement,1407394,00000,1407394,,00000
8 x 10 Tasveer,1407045,00000,1407045,,00000
Affaire de famille,1405432,00000,1405432,,00000
The Tall Man,1405146,00000,1405146,822693,00000
Metropolis,1405032,673414,731618,,15000000
Shirin Farhad Ki Toh Nikal Padi,1401090,00000,1401090,,00000
Class of 1999,1400149,1400149,00000,,00000
Birdy,1400000,1400000,00000,,00000
Suddenly,1400000,1400000,00000,,00000
Arch of Triumph,1400000,1400000,00000,,00000
13B,1398956,12449,1386507,,00000
Ushpizin,1397999,1397999,00000,,00000
Die Relativitätstheorie der Liebe,1397899,00000,1397899,,00000
Surveillance,1396395,27349,1369046,,3500000
The Last of the Finest,1395694,1395694,00000,,00000
Jesus Camp,1394989,902544,492445,,00000
Leonard Cohen: I'm Your Man,1394254,1044254,350000,,00000
Courage Mountain,1393610,1393610,00000,,00000
Slow West,1391848,229094,1162754,19198,00000
X Games 3D: The Movie,1391434,1391434,00000,,00000
Big Bang,1388637,00000,1388637,,00000
Give My Regards to Broad Street,1387440,1387440,00000,,00000
The U.S. vs John Lennon,1387320,1109146,278174,,00000
Joe Gould's Secret,1387255,642018,745237,,00000
Romeo et Juliette,1386582,1386582,00000,,00000
"For a Good Time, Call",1384038,1251749,132289,,850000
Uri Dongne,1383716,00000,1383716,,00000
Book of Love,1382259,1382259,00000,,00000
Bully,1381824,881824,500000,,2100000
Certain Fury,1381091,1381091,00000,,00000
'Luv Shuv Tey Chicken Khurana,1380439,143900,1236539,,00000
The Claim,1375635,622023,753612,,13000000
"Gandhi, My Father",1375194,240425,1134769,,5000000
Daddy's Dyin'… Who's Got the Will?,1373728,1373728,00000,,00000
Dogtooth,1373407,110248,1263159,,323000
Sono Toki Wa Kare Ni Yoroshiku,1373395,00000,1373395,,00000
South Central,1373196,1373196,00000,,00000
Dangerous Games,1372000,00000,1372000,,00000
Locke,1370646,1370646,00000,122539,00000
Dot the I,1368936,306224,1062712,,00000
"Yes, Giorgio",1368588,1368588,00000,,00000
Little Nemo: Adventures in Slumberland,1368210,1368210,00000,,00000
Joshua,1366733,1366733,00000,,00000
American Desi,1366235,902835,463400,,250000
Julia,1365108,65108,1300000,,6000000
Strange Invaders,1362303,1362303,00000,,00000
Money Hai Toh Honey Hai,1362184,00000,1362184,,00000
Leaving Normal,1361232,1361232,00000,,00000
Gimme Shelter,1359910,1359910,00000,167204,00000
Spanking the Monkey,1359736,1359736,00000,,00000
Turtle: The Incredible Journey,1358840,391942,966898,,00000
Sorceress,1358792,1358792,00000,,00000
The Offspring,1355728,1355728,00000,,1100000
The Secrets of Jonathan Sperry,1355079,1355079,00000,,00000
Kansas City,1353824,1353824,00000,,19000000
The City of Your Final Destination,1353296,493296,860000,,8300000
2011 Oscar Shorts,1352152,1352152,00000,,00000
Exposed,1352083,1352083,00000,,00000
Ponette,1351319,1351319,00000,,00000
Platoon Leader,1348771,1348771,00000,,00000
Mean Creek,1348750,603951,744799,,500000
The Cokeville Miracle,1348630,1348630,00000,,00000
At Play in the Fields of the Lord,1342903,1342903,00000,,00000
"No Eres Tu, Soy Yo",1339911,1339911,00000,,00000
Le Capital,1339715,22400,1317315,34098,00000
A Dirty Shame,1339668,1339668,00000,,00000
GoBots: War of the Rock Lords,1338264,1338264,00000,,00000
Forces spéciales,1335641,10759,1324882,,00000
Henry Fool,1334786,1334786,00000,,00000
Nikte,1333891,00000,1333891,,00000
The Navigator: A Mediaeval Odyssey,1333379,1333379,00000,,00000
Alexandra's Project,1333277,750241,583036,,00000
Les adieux à la reine,1329660,1329660,00000,,00000
In Search of a Midnight Kiss,1329014,172177,1156837,,00000
Jing ke ci qin wang,1328435,1328435,00000,,00000
The Ultimate Life,1327841,1327841,00000,1319125,00000
La proie,1327670,06310,1321360,,00000
Black,1327328,754819,572509,,00000
The Work and the Glory III: A House Divided,1325092,1325092,00000,,00000
Trois couleurs: Bleu,1324974,1324974,00000,,00000
Damsels in Distress,1324299,1007535,316764,,3000000
Sarah Silverman: Jesus is Magic,1324244,1324244,00000,,00000
Der 7bte Zwerg,1324167,00000,1324167,18519,00000
Eagle vs Shark,1323878,221846,1102032,,00000
Svadba Po Obmenu,1323774,00000,1323774,,00000
The Program,1322374,00000,1322374,,00000
Travellers and Magicians,1322161,506793,815368,,1800000
Air Racers 3D,1321957,1309987,11970,,00000
Divided We Fall,1320112,1320112,00000,,00000
Warriors of Heaven and Earth,1318382,82382,1236000,,00000
Catfish in Black Bean Sauce,1315573,1315573,00000,,00000
The Kings of Summer,1315500,1315500,00000,,00000
Loro chi?,1314576,00000,1314576,,00000
The Stoning of Soraya M.,1313014,655871,657143,,00000
Baby It's You,1312473,1312473,00000,,00000
Saints and Soldiers,1310470,1310470,00000,,780000
Off the Map,1310368,1310368,00000,,00000
The Celluloid Closet,1310167,1310167,00000,,00000
The Good German,1308696,1308696,00000,,32000000
Scar,1308216,00000,1308216,,00000
The Funeral,1306233,1106233,200000,,12500000
Babar: The Movie,1305187,1305187,00000,,00000
8 Million Ways to Die,1305114,1305114,00000,,00000
"Three Investigators and the Secret of Terror Castle, The",1303981,00000,1303981,,00000
Woman Thou Art Loosed On the 7th Day,1301562,1301562,00000,,00000
Touch and Go,1300000,1300000,00000,,00000
Eddie Macon's Run,1300000,1300000,00000,,00000
The Legend of Rita,1299953,666565,633388,,00000
American Movie: The Making of Northwestern,1299524,1160426,139098,,00000
Hooked On You,1299428,00000,1299428,,00000
Everybody Wins,1299327,1299327,00000,,00000
Radioland Murders,1299060,1299060,00000,,00000
Conversations with Other Women,1297745,379418,918327,,450000
"War, Inc.",1297520,578527,718993,1402194,10000000
Paper Heart,1296971,1274062,22909,,00000
The Legend of Barney Thomson,1294450,00000,1294450,,00000
Usagi Doroppu,1290391,00000,1290391,,00000
Eklavya - The Royal Guard,1290212,1290212,00000,,00000
Main Aurr Mrs. Khanna,1289846,197183,1092663,,00000
The Business of Strangers,1288337,1028337,260000,,6000000
29th Street,1287171,1287171,00000,,00000
Le hussard sur le toit,1286429,1286429,00000,,35000000
Chalo Dilli,1286011,72486,1213525,,00000
Wool-hak-kyo I-ti,1283207,00000,1283207,,00000
Assassination Tango,1282877,1000673,282204,,00000
Bread and Roses,1282593,536465,746128,,00000
Festival Express,1282345,1172345,110000,,00000
Startup.com,1280975,1280975,00000,,00000
La cité des enfants perdus,1280446,1280446,00000,,00000
Nightwatch,1278516,1278516,00000,,00000
I Spit on Your Grave,1278471,93051,1185420,,1750000
Luang Pee Teng 2,1277605,00000,1277605,,00000
The Celestine Prophecy,1276994,1214661,62333,,00000
Apartment 1303,1274006,00000,1274006,,00000
The Flying Scotsman,1271817,171817,1100000,,00000
Company Business,1270483,1270483,00000,,00000
Saving Face,1269705,1187266,82439,,2500000
Gloria,1267863,00000,1267863,13866,00000
Meerkats,1267658,845613,422045,,00000
City of Hope,1264910,1264910,00000,,00000
Phat Beach,1263945,1263945,00000,,00000
Bou ying,1263404,00000,1263404,,00000
When a Stranger Calls,1262052,1262052,00000,,00000
Holy Girl,1261792,304124,957668,,1400000
Blue in the Face,1260496,1260496,00000,,00000
The Abandoned,1255524,1255524,00000,2543282,00000
Looking for Richard,1253153,1253153,00000,,00000
Encounters at the End of the World,1252613,944933,307680,,00000
The Ward,1252014,07760,1244254,,00000
Third Person,1251539,1019038,232501,434923,00000
The Singles Ward,1250798,1250798,00000,,500000
Outlander,1250617,166003,1084614,2583891,50000000
MVP: Most Valuable Primate,1248746,1248746,00000,,00000
L'avocat de la terreur,1247724,47724,1200000,,00000
Duo Ming Xin Tiao,1247300,00000,1247300,,00000
Losin' It,1246141,1246141,00000,,7000000
Toutes nos envies,1245147,22517,1222630,,00000
Turn It Up,1244676,1244676,00000,,00000
The Comfort of Strangers,1244000,1244000,00000,,00000
The Three Musketeers,1243930,1243930,00000,,00000
Walking the Camino: Six Ways to Santiago,1242536,612717,629819,,00000
Et si on vivait tous ensemble?,1240236,43180,1197056,,00000
Picture Bride,1238905,1238905,00000,,00000
Nuit de Noces,1238180,1238180,00000,,00000
"Car 54, Where Are You?",1238080,1238080,00000,,00000
Slow Burn,1237615,1237615,00000,2237884,15500000
Beyond the Mask,1236094,1236094,00000,517259,00000
Turkey Shoot,1233657,1233657,00000,,00000
The Invisible Woman,1233347,1233347,00000,,00000
The Fourth War,1232285,1232285,00000,,00000
You Got Served: Beat The World,1230542,00000,1230542,,10000000
Nueba Yol,1229715,1229715,00000,,00000
Slacker,1227508,1227508,00000,,23000
Singham Returns,1226581,1226581,00000,,00000
Main Prem Ki Diwani Hoon,1225908,1225908,00000,,00000
Inequality for All,1225769,1205079,20690,3022098,00000
Vital Signs,1224605,1224605,00000,,00000
The Lonely Lady,1223220,1223220,00000,,00000
One Tough Cop,1220906,1220906,00000,,00000
Le fils de l'autre,1220807,1220807,00000,,00000
Kencho Omotenashi Ka,1218403,00000,1218403,,00000
Blackthorn,1217307,200558,1016749,,4500000
Love at Large,1214295,1214295,00000,,00000
Tous à l'Ouest: Une aventure de Lucky Luke,1213399,00000,1213399,,00000
A Time of Destiny,1212487,1212487,00000,,00000
Broken,1212304,00000,1212304,,00000
The General,1211865,1211865,00000,,00000
I'm the One That I Want,1210967,1210967,00000,,00000
Twixt,1207503,00000,1207503,,7000000
Metropolis,1206834,1206834,00000,,00000
Kickboxer 2,1206817,1206817,00000,,00000
The Hot Spot,1206153,1206153,00000,,00000
Running Brave,1204595,1204595,00000,,00000
X+Y,1202437,139511,1062926,,00000
Ultraman Mebius & Ultraman Brothers,1201351,00000,1201351,,00000
Darling Companion,1200346,793352,406994,,12000000
"Beats, Rhymes & Life: The Travels of a Tribe Called Quest",1200046,1200046,00000,,00000
The Lights of New York,1200000,1200000,00000,,00000
Ninotchka,1200000,1200000,00000,,00000
The Legend of Blood Mountain,1200000,1200000,00000,,00000
"Invasion, U.S.A.",1200000,1200000,00000,,00000
"Souffle au Coeur, Le",1200000,1200000,00000,,00000
De Sade,1200000,1200000,00000,,00000
The Premature Burial,1200000,1200000,00000,,00000
Summer Lovers,1200000,1200000,00000,,00000
Pidtermyai huajai wawoon,1200000,00000,1200000,,00000
Pieces,1198346,1198346,00000,,00000
Sammy and Rosie Get Laid,1196336,1196336,00000,,00000
00012,1193022,00000,1193022,,00000
High Hopes,1192322,1192322,00000,,00000
Dancers,1190416,1190416,00000,,00000
Me and Orson Welles,1190003,1190003,00000,,25000000
Indigo,1190000,1190000,00000,,00000
Return to Horror High,1190000,1190000,00000,,00000
Repentance,1189612,1189612,00000,112344,00000
The Lair of the White Worm,1189315,1189315,00000,,00000
Ogawa no Hotori,1188949,00000,1188949,,00000
Ballets Russes,1188468,815848,372620,,00000
Kill the Irishman,1188194,1188194,00000,2507416,00000
Jai Ho,1187266,1187266,00000,,00000
Phantom,1186703,1034589,152114,,18000000
National Theatre Live: The Audience,1185096,00000,1185096,,00000
Backstage,1184727,1184727,00000,,00000
Monica La Mitraille,1182372,1182372,00000,,00000
"Ich seh, Ich seh",1181994,1178196,03798,,00000
Who Killed Bambi?,1181825,14400,1167425,,00000
PiraMMMida,1179887,00000,1179887,,00000
Fiza,1179462,623791,555671,,1000000
Casa de Areia,1178175,539285,638890,,3750000
Real Dad,1172753,00000,1172753,,00000
Don't Tell Her it's Me,1171762,1171762,00000,,00000
President,1171515,00000,1171515,,00000
The Curse,1169922,1169922,00000,,00000
The Remaining,1169603,1169603,00000,138812,00000
Heights,1168405,1158405,10000,,00000
Get Crazy,1168364,1168364,00000,,00000
Groove,1167524,1115313,52211,,500000
The Third Man,1167225,1034144,133081,,00000
The Burning Plain,1167092,200730,966362,,00000
Permanent Midnight,1166199,1166199,00000,,00000
Where Hope Grows,1166052,1156000,10052,,00000
The Lords of Salem,1165881,1165881,00000,2872252,1500000
Goodbye Solo,1165529,871445,294084,,00000
The Best Two Years,1163450,1163450,00000,,00000
Romeo & Juliet,1162635,1162635,00000,324006,00000
Reprise,1162184,554826,607358,,00000
Tarnation,1162014,592014,570000,,400000
The Human Body,1161866,00000,1161866,,00000
To Sleep With Anger,1161135,1161135,00000,,00000
Cousin Bette,1161063,1161063,00000,,00000
Fune Wo Amu,1160990,00000,1160990,,00000
Trois,1160268,1160268,00000,,200000
The Final Season,1159691,1159691,00000,4136175,00000
Shaitan,1158373,00000,1158373,,00000
Shower,1157764,1157764,00000,,00000
Chuck&Buck,1157672,1055671,102001,,250000
Sur le chemin de l'ecole,1156942,07424,1149518,,00000
The Good Wife,1155020,1155020,00000,,00000
Still Mine,1154466,1154466,00000,327202,00000
Paperclips,1153221,1121744,31477,,00000
The Wrong Guys,1152786,1152786,00000,,00000
Bure baruta,1152411,1152411,00000,,00000
Get Real,1152411,1152411,00000,,2000000
Excessive Force,1152117,1152117,00000,,13000000
Incorregibles,1150605,00000,1150605,,00000
Someone Behind You,1150497,00000,1150497,,00000
Grace Is Gone,1150224,50080,1100144,,00000
Nightflyers,1149470,1149470,00000,,00000
Trishna,1148956,240381,908575,,00000
The Son of No One,1148578,30680,1117898,1407662,15000000
Lolita,1147784,1147784,00000,,55000000
December Boys,1146474,46474,1100000,,00000
He ni zai yi qi,1145190,1145190,00000,,00000
Liberal Arts,1143950,319176,824774,,00000
Sugar,1143922,1081922,62000,,00000
Hellphone,1141070,00000,1141070,,00000
L.I.E.,1140965,1140965,00000,,700000
The Assassination of Richard Nixon,1140051,708776,431275,,00000
Being Flynn,1139706,540152,599554,,00000
I Like It Like That,1138499,1138499,00000,,00000
Jeszcze Raz,1136947,00000,1136947,,00000
Yi Yi,1136776,1136776,00000,,00000
Wetherby,1136052,1136052,00000,,00000
"Yoo-Hoo, Mrs. Goldberg",1134623,1134623,00000,,00000
In the Shadow of the Moon,1134358,1134358,00000,,2000000
Tokyo!,1134059,351059,783000,,00000
Valmont,1132000,1132000,00000,,00000
Half Moon Street,1131399,1131399,00000,,00000
Sholem Aleichem: Laughing in the Darkness,1131261,1131261,00000,,500000
Outlaw,1127359,00000,1127359,,00000
Die Rote Zora,1126576,00000,1126576,,00000
Life,1126467,00000,1126467,,00000
The Ballad of Jack and Rose,1126258,712294,413964,,1500000
The Thief,1126115,1126115,00000,,00000
The Deep Blue Sea,1126027,1126027,00000,,00000
Cold Souls,1125209,905209,220000,,00000
High Season,1125000,1125000,00000,,00000
L'Ennemi Intime,1122695,00000,1122695,,00000
"Wilden Huhner und die Liebe, Die",1121517,00000,1121517,,00000
Hunk,1120536,1120536,00000,,00000
Street Smart,1119112,1119112,00000,,00000
A Price Above Rubies,1118808,1118808,00000,,00000
Eating Raoul,1114825,1114825,00000,,00000
Yves Saint Laurent,1114798,723593,391205,,00000
Baby and Me,1113693,00000,1113693,,00000
Possession,1113538,1113538,00000,,00000
Weeds,1113222,1113222,00000,,00000
Left Luggage,1113208,1113208,00000,,00000
The R.M.,1111615,1111615,00000,,500000
"Tete de Maman, La",1110681,00000,1110681,,00000
The Overnight,1109808,1109808,00000,,00000
Burn,1109276,1109276,00000,,225000
The Rover,1109199,1109199,00000,102593,00000
Joe Strummer: The Future is Unwritten,1108560,248182,860378,,00000
Tamagocchi Doki Doki!,1107976,00000,1107976,,00000
The King of Masks,1106935,1106935,00000,,00000
Where the Heart Is,1106475,1106475,00000,,00000
Gambit,1103703,00000,1103703,226026,00000
Silk,1103075,1103075,00000,,00000
The Heart Specialist,1103037,1103037,00000,,00000
Mistress,1102469,1102469,00000,,00000
Gangster Ka,1102435,00000,1102435,,00000
Unconditional Love,1101999,115202,986797,,00000
Sordid Lives,1101119,1101119,00000,,00000
The Story of Vernon and Irene Castle,1100000,1100000,00000,,00000
Viva Villa!,1100000,1100000,00000,,00000
Mike's Murder,1100000,1100000,00000,,00000
The Beguiled,1100000,1100000,00000,,00000
Jitterbugs,1100000,1100000,00000,,00000
Kafka,1100000,1100000,00000,,00000
Diana Vreeland: The Eye Has to Travel,1098596,1004821,93775,,00000
Bl&#229; M&#230;nd,1097992,00000,1097992,,00000
Once Upon a Time in the Midlands,1097508,171830,925678,,00000
Little Odessa,1095885,1095885,00000,,00000
Anime nere,1094080,100725,993355,,00000
Two Stupid Eggs,1094000,00000,1094000,,00000
Heart of Dixie,1093011,1093011,00000,,00000
Miracle Mile,1092822,1092822,00000,,00000
Swimming to Cambodia,1092000,1092000,00000,,00000